Ni**as In Paris	JAY-Z, Kanye West	Watch The Throne (Deluxe)	spotify:track:4Li2WHPkuyCdtmokzW2007

Play Hard (feat. Ne-Yo & Akon) - New Edit	David Guetta, Akon, Ne-Yo	Play Hard (feat. Ne-Yo & Akon) [New Edit]	spotify:track:16Cs9KsHzgunxaEfGrXysG

Hangover	Taio Cruz, Flo Rida	TY.O (International Version)	spotify:track:2tftivjRsvKs0jFH9h3Ti8

Break Your Heart	Taio Cruz	The Rokstarr Hits Collection	spotify:track:7ElF5zxOwYP4qVSWVvse3W

In My Head	Jason Derulo	Jason Derulo (International)	spotify:track:6St9lR6dhV2tpCNVz7qfrS

Animals - Radio Edit	Martin Garrix	Animals	spotify:track:6TwY5jCWaPnju5vBai4Fch

DJ Got Us Fallin' In Love (feat. Pitbull)	Usher, Pitbull	Raymond v Raymond (Expanded Edition)	spotify:track:4356Typ82hUiFAynbLYbPn

Yeah! (feat. Lil Jon & Ludacris)	Usher, Lil Jon, Ludacris	Confessions (Expanded Edition)	spotify:track:5rb9QrpfcKFHM1EUbSIurX

Intoxicated - Radio Edit	Martin Solveig, Good Times Ahead	Intoxicated (Radio Edit)	spotify:track:49aLCvvEKM5EA8IYwDmtaE

Wicked Wonderland	Tungevaag	Wicked Wonderland	spotify:track:4CnbiWjq0i7YPhKNnmt10T

In Da Club	50 Cent	Get Rich Or Die Tryin'	spotify:track:7iL6o9tox1zgHpKUfh9vuC

Sweet Nothing (feat. Florence Welch)	Calvin Harris, Florence Welch	18 Months	spotify:track:24LS4lQShWyixJ0ZrJXfJ5

Under Control	Calvin Harris, Alesso, Hurts	Motion	spotify:track:4J7CKHCF3mdL4diUsmW8lq

We Found Love	Rihanna, Calvin Harris	We Found Love (German 2 trk)	spotify:track:4ZKkRL1cc1YBRSYtPj2pqC

Give Me Everything	Pitbull, Ne-Yo, Afrojack, Nayer	Planet Pit (Deluxe Version)	spotify:track:4QNpBfC0zvjKqPJcyqBy9W

Levels - Radio Edit	Avicii	Levels	spotify:track:0JhKJg5ejeQ8jq89UQtnw8

Take Over Control - Radio Edit	Afrojack, Eva Simons	Take Over Control	spotify:track:5x1BUS62MKVxQiRxIKtbCe

Mr. Saxobeat - Radio Edit	Alexandra Stan	Saxobeats	spotify:track:2N3vhJx8MAtRAxQyRetBn3

One Night in Ibiza - Radio Mix	Mike Candys, Evelyn, Patrick Miller	Smile	spotify:track:4m7oY61QIG5E9ZNybGXYxJ

Welcome to St. Tropez - DJ Antoine vs Mad Mark Radio Edit	DJ Antoine, Kalenna	Welcome to DJ Antoine	spotify:track:5QIG1kl6klZIy0Lu67XNYJ

I Like - Jost & Grubert Radio Mix	Keri Hilson	I Like (German Version)	spotify:track:6Sx1KqzubEJsnLwlj0XbcR

Maneater	Nelly Furtado	Loose (International Version)	spotify:track:4wH4dJgrsxONID6KS2tDQM

Sun Is Up - Play & Win Radio Edit	INNA	Sun Is Up	spotify:track:2VyaNznJQir0MEz3yWWRmd

Sexy Bitch	David Guetta, Akon	Freedom (Int'l Version 2)	spotify:track:3afsgHDntgKNOKkrYDmDKb

Traum	Cro	Traum	spotify:track:7jIRQUJbgJSakbO87fZihr

Bad (feat. Vassy) - Radio Edit	David Guetta, Showtek, Vassy	Lovers on the Sun EP	spotify:track:1Nivqu7wynKsgguBmgC6Vw

Turn All the Lights On	T-Pain, Ne-Yo	rEVOLVEr (Deluxe Version)	spotify:track:5Ue25r0VGvZR7vaw3iB0gZ

#SELFIE - Original Mix	The Chainsmokers	#SELFIE	spotify:track:6jEhWcVKEgbczzrU4p2X5u

Black Pearl (He's a Pirate) - Radio Edit	Rebel, Sidney Housen	Black Pearl (He´s a Pirate)	spotify:track:1LdOS2Uw0OK3mzPAuFXb3c

I'm an Albatraoz	AronChupa	I'm an Albatraoz	spotify:track:5MhsZlmKJG6X5kTHkdwC4B

Moves Like Jagger - Studio Recording From The Voice Performance	Maroon 5, Christina Aguilera	Hands All Over (Revised International Standard version)	spotify:track:7pYfyrMNPn3wtoCyqcTVoI

Sexy And I Know It	LMFAO	Sorry For Party Rocking	spotify:track:70Vdd1gx5tn84jkAU31ASv

Rack City	Tyga	Careless World: Rise Of The Last King	spotify:track:21nFIDqoD1L7ELsprVSzOR

Body Language (feat. Usher & Tinashe)	Kid Ink, Usher, Tinashe	Full Speed	spotify:track:6rYqZNY6Dkrs8UZMxT50Xw

Show Me	Kid Ink, Chris Brown	My Own Lane	spotify:track:2q6j0nlwgKlYy7xgrria4S

Black and Yellow	Wiz Khalifa	Rolling Papers	spotify:track:5A6OHHy73AR5tLxgTc98zz

Empire State Of Mind	JAY-Z, Alicia Keys	The Blueprint 3	spotify:track:3lPAHV0b53zgRRm9LBgnTY

Like A G6	Far East Movement, The Cataracs, DEV	Dirty Bass (Deluxe)	spotify:track:2s5YN9O8Qv25BjQobPHWVZ

Insomnia - Radio Edit	Mike Candys, Jack Holiday	Insomnia	spotify:track:06lcd19PrFrfzOwSlAjGzM

Breathing	Jason Derulo	Future History (Deluxe Edition)	spotify:track:12HgZnRqGPwIZJD0gPsUor

Don't Wanna Go Home	Jason Derulo	Future History (Deluxe Edition)	spotify:track:1r3myKmjWoOqRip99CmSj1

I Need Your Love (feat. Ellie Goulding)	Calvin Harris, Ellie Goulding	18 Months	spotify:track:05SBRd4fXgn8FX7bf8BCAE

Ridin'	Chamillionaire, Krayzie Bone	Ridin'	spotify:track:73qbHEi2infwn7MFXneeDq

Danza Kuduro (Throw Your Hands Up)	Lucenzo, Qwote, Pitbull	Danza Kuduro (Throw Your Hands Up)	spotify:track:5D2RGA8vdMkz7GPQYoJ6Tz

Don't You Worry Child - Radio Edit	Swedish House Mafia, John Martin	Don't You Worry Child	spotify:track:2V65y3PX4DkRhy1djlxd9p

Can't Hold Us - feat. Ray Dalton	Macklemore & Ryan Lewis	The Heist	spotify:track:3bidbhpOYeV4knp8AIu8Xn

Party Rock Anthem	LMFAO, Lauren Bennett, GoonRock	Sorry For Party Rocking	spotify:track:7mitXLIMCflkhZiD34uEQI

Memories (feat. Kid Cudi)	David Guetta, Kid Cudi	Memories (feat. Kid Cudi)	spotify:track:7KPr0YxECy4Q1k2F17Sa0Q

I Gotta Feeling	The Black Eyed Peas	THE E.N.D. (THE ENERGY NEVER DIES) [International Version]	spotify:track:70cTMpcgWMcR18t9MRJFjB

Remmidemmi (Yippie Yippie Yeah)	Deichkind	Aufstand im Schlaraffenland	spotify:track:31sD77U64ym70wYEMpnSrQ

Don't Stop The Music	Rihanna	Good Girl Gone Bad: Reloaded	spotify:track:0ByMNEPAPpOR5H69DVrTNy

Wake Me Up	Avicii	True	spotify:track:4h8VwCb1MTGoLKueQ1WgbD

Alors On Danse - Radio Edit	Stromae	Alors On Danse	spotify:track:5De1awgRD22uGK8fVLfE4d

Promiscuous	Nelly Furtado, Timbaland	The Best of Nelly Furtado (Deluxe)	spotify:track:3SwlakM6VX47IwG0Wll5ek

Drop It Like It's Hot	Snoop Dogg, Pharrell Williams	Drop It Like It's Hot (International Version)	spotify:track:4Tyv7nnNTHC6mR1pTubIrw

Get Low	Ying Yang Twins, Lil Jon & The East Side Boyz	Kings Of Crunk	spotify:track:0r2Bul2NuCViraT2zX1l5j

Low (feat. T-Pain)	Flo Rida, T-Pain	Mail on Sunday	spotify:track:0CAfXk7DXMnon4gLudAp7J

Just Dance	Lady Gaga, Colby O'Donis	Just Dance (International Version)	spotify:track:20Hgxa2WX0Q5KlZAR5sFCO

Umbrella	Rihanna, JAY-Z	Good Girl Gone Bad: Reloaded	spotify:track:49FYlytm3dAAraYgpoJZux

Good Feeling	Flo Rida	Good Feeling	spotify:track:3NcO4jGK1Opb5ea0mYLpxb

Turn Down for What	DJ Snake, Lil Jon	Turn Down for What	spotify:track:67awxiNHNyjMXhVgsHuIrs

I Could Be The One (Avicii Vs. Nicky Romero) - Nicktim / Radio Edit	Avicii, Nicky Romero	I Could Be The One [Avicii vs Nicky Romero]	spotify:track:2bNrvWD9d5Zn9tS8XvcaMk

I Follow Rivers - The Magician Remix	Lykke Li, The Magician	I Follow Rivers (The Magician Remix)	spotify:track:4Jv7lweGIUOFQ7Oq2AtAh9

I Love It (feat. Charli XCX) - Original Version	Icona Pop, Charli XCX	I Love It	spotify:track:3VZQshi4COChhXaz7cLP02

Reload - Vocal Version / Radio Edit	Sebastian Ingrosso, Tommy Trash, John Martin	Reload (Vocal Version / Radio Edit)	spotify:track:40AYRnDKhhrH4JZO4KS9Dj

Timber	Pitbull, Kesha	Timber	spotify:track:1zHlj4dQ8ZAtrayhuDDmkY

One (Your Name) - Radio Edit	Swedish House Mafia, Pharrell Williams	One (Your Name)	spotify:track:1qZMPmpD1jDcOA7gZ6TCde

Scream	Usher	Looking 4 Myself (Deluxe Version)	spotify:track:5sAlmL7Qp9N9BJTADkwEt9

Turn This Club Around - Video Edit	R.I.O., U-Jean	Turn This Club Around (Deluxe Edition)	spotify:track:0xvAZWXbwNb7nDGmwyPXQ8

Das geht ab - Wir feiern die ganze Nacht - Atzen Musik Mix	Frauenarzt, Manny Marc	Das Geht Ab (Wir Feiern Die Ganze Nacht)	spotify:track:020dAZXj8gLtO6vMabc1be

Disco Pogo - Atzen Musik Mix	Die Atzen	Disco Pogo	spotify:track:66sA9JeAeRuN1ZMtvthPQM

C'est beau la bourgeoisie - Radio Edit	Discobitch	C'est beau la bourgeoisie	spotify:track:22OZbdiOvRdocdyafcGAgI

Get Shaky - Ian Carey Original Radio Edit	Ian Carey Project	Get Shaky	spotify:track:1wSFyAwUGqrLauh3MdjMsM

Infinity 2008	Guru Josh Project	Radio 538 presents HOT! - The Best Summer Jams For 2010	spotify:track:6eJOGt26nUe5cbFh1J0Jxh

Tsunami	DVBBS, Borgeous	Tsunami	spotify:track:6Fov34aYnGxPfcAOYEnv8j

Day 'N' Nite	Kid Cudi, Crookers	Day 'n Nite	spotify:track:36JWGQRW85mJYLXvnryEzL

Watch Out For This (Bumaye) [feat. Busy Signal, The Flexican & FS Green]	Major Lazer, Busy Signal, FS Green, The Flexican	Free The Universe Deluxe	spotify:track:2vTdEBKuXAFi6T0IbRuDff

King	Years & Years	King	spotify:track:6pIZ0u32c2Lku8PmCWtnMy

	, , , 		spotify:track:69gRFGOWY9OMpFJgFol1u0

Hotel Room Service	Pitbull	Pitbull Starring In Rebelution	spotify:track:6Rb0ptOEjBjPPQUlQtQGbL

Little Bad Girl - feat. Taio Cruz & Ludacris	David Guetta	Nothing But The Beat	spotify:track:06vrB5Ldq2NDJ9eAs7T1WM

Every time we touch	Cascada	Everytime We Touch [Premium Edition]	spotify:track:2gOlrge3YTmYPwsCGgU62K

We No Speak Americano - Radio Edit	Yolanda Be Cool, DCup	We No Speak Americano (Yolanda Be Cool vs. DCUP) (Remixes Vol. 1)	spotify:track:6Ljak2OKTpSJSWWRPgiqO4

Party Shaker - Video Edit	R.I.O., Nicco	Party Shaker (feat. Nicco) [Remixes] - EP	spotify:track:5Q5Y5p9Fs77tF2RGyhb79f

Animal - Video Edit	R.I.O., U-Jean	Turn This Club Around (Deluxe Edition)	spotify:track:7bKbQxS0HR9FwBFYQyDArQ

Joli Garçon - Rob & Chris Remix	Lolita Jolie	Joli Garçon	spotify:track:3O59nIEHnGp0eMwVTvZsWi

Einmal um die Welt	Cro	Raop	spotify:track:7tPx0INxzHlxWgOYnmNSgd

Summer Of Love - Edit	Cascada	The Best Of Cascada	spotify:track:5tvhP1n2k7xxOTTq5jAGvm

Diamonds	Rihanna	Unapologetic (Deluxe)	spotify:track:6O20JhBJPePEkBdrB5sqRx

S&M	Rihanna	Loud	spotify:track:0C4ejWmOTMv8vuYj85mf8m

Where Have You Been	Rihanna	Talk That Talk (Deluxe)	spotify:track:1tjY4H0X706ZH03SXa1DFh

Only Girl (In The World)	Rihanna	Only Girl (In The World)	spotify:track:3YJlTDtUXu1sGh8lunblkG

Disturbia	Rihanna	Disturbia (int'l ECD Maxi)	spotify:track:2a6czS7gAiUd69XD222ucW

Who's That Chick ? (feat. Rihanna) [Single Version]	David Guetta, Rihanna	One More Love (Spotify Sampler)	spotify:track:7AGK8ekSavI8oatFnacIAd

SOS - Radio Edit	Rihanna	SOS (Int'l Maxi)	spotify:track:6s0nxbG4hlcvRcsMhkWE7Y

TiK ToK	Kesha	Animal	spotify:track:6nYoTBmGFNgfTyRC8x1Fvp

We R Who We R	Kesha	We R Who We R	spotify:track:0iKKaRZLDcZTlEbXO640B2

Crazy Kids	Kesha, will.i.am	Crazy Kids ft. will.i.am	spotify:track:0jVCylSAwuq6MxuFa0pMPw

Die Young	Kesha	Die Young	spotify:track:3Q24nB1uSmsYgS6rjWW8Ac

Dangerous (feat. Sam Martin)	David Guetta, Sam Martin	Listen	spotify:track:7pqgMEKsDMOHUdFQ7n0N9K

Where Them Girls At (feat. Nicki Minaj & Flo Rida)	David Guetta	Nothing but the Beat (Ultimate Edition)	spotify:track:7ks6AZmFcm3Y6PGGxGSmlB

Whistle	Flo Rida	Wild Ones	spotify:track:3bC1ahPIYt1btJzSSEyyrF

Club Can't Handle Me (feat. David Guetta) - From the Step Up 3D Soundtrack	Flo Rida, David Guetta	Club Can't Handle Me	spotify:track:0xcl9XT60Siji6CSG4y6nb

Right Round (feat. Ke$ha)	Flo Rida, Kesha	Right Round (feat. Ke$ha)	spotify:track:7M8WfC48qkwOJkKMNHCHb7

Single Ladies - Radio Edit	Remady & Manu-L & Manu-L feat. J-Son	The Ultimate Party Dance Hits 2013	spotify:track:6XJekiEgpJIGd1pLMe96Zq

2012 (If the World Would End) - Radio Mix	Mike Candys & Evelyn feat. Patrick Miller	Smile (The 2012 Deluxe Edition)	spotify:track:4xxUIIyAylO2TAvKbQThI1

Sunshine (Fly So High) - 2012 Original Mix	Mike Candys feat. Sandra Wild	Smile (The 2012 Deluxe Edition)	spotify:track:02oHnJB1BWmOj3XALt7d5G

Ma Chérie - DJ Antoine vs Mad Mark 2k12 Radio Edit	DJ Antoine, The Beat Shakers	Welcome to DJ Antoine - Remixed	spotify:track:2CbuG4ib5Wg5q8AEhVgll7

More Than Friends	INNA, Daddy Yankee	Party Never Ends	spotify:track:5dyYMdczVu7jMgc1ks3Fgi

Hot - Play & Win Radio Version	INNA	Hot	spotify:track:0ZvPm4jiOWhi2NzcjNqrD0

Waiting For Love	Avicii	Stories	spotify:track:6nsLzJfvp5OLd4mgqUJkpq

The Nights	Avicii	The Days / Nights	spotify:track:3OwPSJu609AMzotCEyoMiO

Hey Brother	Avicii	True	spotify:track:3zKST4nk4QJE77oLjUZ0Ng

Turn Me On (feat. Nicki Minaj)	David Guetta	Nothing but the Beat (Ultimate Edition)	spotify:track:6T27IN7Ai94BeDv6PPCmoC

Lean On (feat. MØ & DJ Snake)	Major Lazer, MØ, DJ Snake	Peace Is The Mission	spotify:track:4WjH9Bzt3kx7z8kl0awxh4

Summer Jam	R.I.O., U-Jean	Summer Jam (feat. U-Jean) [Remixes] - EP	spotify:track:1FfZ8sEWfZkC9bpT02JVMw

Wizard - Radio Edit	Martin Garrix, Jay Hardway	Wizard	spotify:track:3RmpLtEnQSqosiFCxqJdNP

Center of the Universe - Remode Edit	Axwell	Progressive City Nights, Vol. One	spotify:track:2Sv4pcjABuwxmhNxmwu7yp

Drinking from the Bottle (feat. Tinie Tempah)	Calvin Harris, Tinie Tempah	18 Months	spotify:track:1oHxIPqJyvAYHy0PVrDU98

Heroes (We Could Be)	Alesso, Tove Lo	Heroes	spotify:track:5vLOVP3M0Vg2FaYJnUcrvm

Greyhound	Swedish House Mafia	Until Now	spotify:track:3yY748mGAEg9tSDWhzTSdV

Gangnam Style (강남스타일)	PSY	Gangnam Style (강남스타일)	spotify:track:03UrZgTINDqvnUMbbIMhql

Thrift Shop (feat. Wanz)	Macklemore & Ryan Lewis, Wanz	Thrift Shop (feat. Wanz)	spotify:track:1CmUZGtH29Kx36C1Hleqlz

Scream & Shout	will.i.am, Britney Spears	Scream & Shout	spotify:track:054ue8u2erwwGNgSIZLEPq

Don't You Worry Child (Radio Edit) [feat. John Martin]	Swedish House Mafia	Don't You Worry Child (Radio Edit) [feat. John Martin]	spotify:track:1oF75Qbv8UvOBm1imUAE51

And We Danced (feat. Ziggy Stardust)	Macklemore	The Unplanned Mixtape	spotify:track:1FCQEg7wOK9IIBuxx63krr

On The Floor - Radio Edit	Jennifer Lopez, Pitbull	On The Floor	spotify:track:7Hv89f7Dpm5Hce1XkBbjQZ

Sweat - Remix	Snoop Dogg, David Guetta, Giorgio Tuinfort, Frederic Riesterer	Sweat (Snoop Dogg Vs. David Guetta) [Remix]	spotify:track:0R7YVi7w41Dr9jU5vblAok

Loca People - Radio Edit	Sak Noel	Anual 2011	spotify:track:1j6KjXJbPrzLs1zZcJPXu3

Call Me Maybe	Carly Rae Jepsen	Kiss (Deluxe)	spotify:track:3TGRqZ0a2l1LRblBkJoaDx

Summer	Calvin Harris	Summer	spotify:track:7b71WsDLb8gG0cSyDTFAEW

Prayer in C - Robin Schulz Radio Edit	Lilly Wood and The Prick, Robin Schulz	Prayer In C	spotify:track:5fnA9mkIfScSqHIpeDyvck

Endless Summer - Single Mix	Oceana	Endless Summer	spotify:track:5xAIUVGwT12C3zodyvLvji

My Party - Radio Version	DJane HouseKat, Rameez	My Party	spotify:track:3psI1DmyO9ErdqIAd4CMEl

Ain't Nobody (Loves Me Better)	Felix Jaehn, Jasmine Thompson	Ain't Nobody (Loves Me Better)	spotify:track:5afHIkEcVhCF1Z1CTqMUXB

Rattle - Original Mix	Bingo Players	Rattle	spotify:track:48g4Cw3ZfXMQw4gGpUxbt4

If I Lose Myself - Alesso vs OneRepublic	OneRepublic, Alesso	If I Lose Myself (Alesso vs OneRepublic)	spotify:track:0AhRPDuVwHkLAACbPXidb3

Bang My Head (feat. Sia & Fetty Wap)	David Guetta	Listen Again	spotify:track:53Y0kdCa1CZ9gRqEuknfwy

Show Me Love 2015 - Radio Edit	Sean Finn	Show Me Love 2015 (Remixes)	spotify:track:60zzvAeM7LKWB8vBcEBhJU

Samsara (feat. Emila)	Tungevaag, Raaban, Emila	Samsara (feat. Emila)	spotify:track:6oJflQkp7lFXOQce4wPTAW

This Is What It Feels Like	Armin van Buuren, Trevor Guthrie	This Is What It Feels Like	spotify:track:6NdkzOSCLzmyV9Qc4DKhJ2

Red Lights	Tiësto	Red Lights	spotify:track:3bT5PDBhVj4ifU11zQvGP2

Don't Tell 'Em	Jeremih, YG	Don't Tell 'Em	spotify:track:5rph5sObvxskRcb1JLV70r

Everybody - Radio Edit	Mike Candys, Evelyn, Tony T	Everybody	spotify:track:4ADAhq9aMMzETmSa81VBfv

Let's Go (feat. Ne-Yo)	Calvin Harris, Ne-Yo	18 Months	spotify:track:4wkQmYpAaMe41Rc3sYZ7Vz

Got 2 Luv U	Sean Paul, Alexis Jordan	Tomahawk Technique	spotify:track:62pSYErgGri97X9aIyBzHm

Geronimo - Jost & Damien Radio Mix	Aura Dione	Before The Dinosaurs	spotify:track:6321GCY8UDdks0yGuOnqzX

In the Name of Love	Martin Garrix, Bebe Rexha	In the Name of Love	spotify:track:23L5CiUhw2jV1OIMwthR3S

Cold Water (feat. Justin Bieber & MØ)	Major Lazer, Justin Bieber, MØ	Cold Water (feat. Justin Bieber & MØ)	spotify:track:6DNtNfH8hXkqOX1sjqmI7p

The Greatest	Sia	This Is Acting (Deluxe Version)	spotify:track:6bLopGnirdrilrpdVB6Um1

Cheap Thrills	Sia	This Is Acting	spotify:track:7BPw9h8vCIX94N0rjFU12S

SUBEME LA RADIO	Enrique Iglesias, Descemer Bueno, Zion & Lennox	SUBEME LA RADIO	spotify:track:7nKBxz47S9SD79N086fuhn

Despacito (Featuring Daddy Yankee)	Luis Fonsi, Daddy Yankee	Despacito (Featuring Daddy Yankee)	spotify:track:4aWmUDTfIPGksMNLV2rQP2

Shape of You	Ed Sheeran	÷ (Deluxe)	spotify:track:7qiZfU4dY1lWllzX7mPBI3

Rockabye (feat. Sean Paul & Anne-Marie)	Clean Bandit, Sean Paul, Anne-Marie	Rockabye (feat. Sean Paul & Anne-Marie)	spotify:track:5knuzwU65gJK7IF5yJsuaW

More - RedOne Jimmy Joker Remix	Usher	More	spotify:track:0aBKFfdyOD1Ttvgv0cfjjJ

Pon de Replay	Rihanna	Music Of The Sun	spotify:track:3U3Ff8ZvL6oEu1r98gCCWW

Tacatà - Radio Edit	Tacabro	Ritmo de la Calle	spotify:track:1wqLuwQeQUad5IDcbtmWcX

Calabria 2008	Natasja	Shooting Star	spotify:track:4MlfMyLq5REr81WoHM6y0N

Live My Life	Far East Movement, Justin Bieber	Dirty Bass (Deluxe)	spotify:track:6dpKQiQzZE2r9rZVWeLGom

Cry for You - UK Radio Edit	September	Gold	spotify:track:2FuJvdLfBf8eUmgtlz3Rb3

Bonbon	Era Istrefi	Bonbon EP	spotify:track:79Nnbjlw4ulw59lkHUZm9N

Light It Up (feat. Nyla & Fuse ODG) - Remix	Major Lazer, Nyla, Fuse ODG	Peace Is The Mission: Extended	spotify:track:6lDo13SSgTv0WbyUQKgnjk

Like I Do	David Guetta, Martin Garrix, Brooks	Like I Do	spotify:track:6RnkFd8Fqqgk1Uni8RgqCQ

Without You (feat. Sandro Cavazza)	Avicii, Sandro Cavazza	AVĪCI (01)	spotify:track:6WbADFqMvR8N5u0BvtsWQE

Dreamer	Axwell /\ Ingrosso	Dreamer	spotify:track:7BfiAzV3ASEK9egnfxN1v1

More Than You Know	Axwell /\ Ingrosso	More Than You Know	spotify:track:4q8PHoRsPUB52LFylX8Ulz

Cool Me Down - Mike Candys Remix	Margaret, Mike Candys	Cool Me Down (Remixes)	spotify:track:3Wkq5MEETQXtUxo0bsBVlC

Instagram	Dimitri Vegas & Like Mike, David Guetta, Daddy Yankee, Afro Bros, Natti Natasha, Dimitri Vegas, Like Mike	Instagram	spotify:track:0U6bQIAh6MCGo1xjbIIx2S

Who's That Chick? (feat. Rihanna)	David Guetta	One More Love	spotify:track:6qUSs4FDzZUdAhY6JDIJfa

Do It All Night 2k12 - Video Mix	Darius & Finlay, Carlprit, Nicco	Do It All Night 2k12	spotify:track:7DNTCb60V4Ec42KBZ3QkOK



pop 2015 - 2016 - 2017

Stay	Kygo, Maty Noyes	Stay	spotify:track:7gBj0VgcuAgkXkiRRYvSmK

Work	Rihanna, Drake	ANTI (Deluxe)	spotify:track:14WWzenpaEgQZlqPq2nk4v

Cake By The Ocean	DNCE	SWAAY	spotify:track:42ftjU4cTN5UTRksyqBKZJ

Cheap Thrills	Sia	This Is Acting	spotify:track:27SdWb2rFzO6GWiYDBTD9j

Reality - Radio Edit	Lost Frequencies, Janieck Devy	Reality	spotify:track:5kZRoc6Gz7u5eu4a0YM2LS

Hands To Myself	Selena Gomez	Revival (Deluxe)	spotify:track:1LoriJC05IrHIDwj3q0KC1

Stitches	Shawn Mendes	Handwritten (Deluxe)	spotify:track:1WP1r7fuvRqZRnUaTi2I1Q

Fast Car	Jonas Blue, Dakota	Fast Car	spotify:track:6OZh916QF8XNunWaP97WEZ

Running Out	Matoma, Astrid S	Running Out	spotify:track:2H8LPaY3NSjmOFMH2Rygnz

Don't Let Me Down	The Chainsmokers, Daya	Don't Let Me Down	spotify:track:1i1fxkWeaMmKEB4T7zqbzK

Picky	Joey Montana	Picky	spotify:track:0ZogPPD0uFaPXVhlZJOtSK

Light It Up (feat. Nyla & Fuse ODG) - Remix	Major Lazer, Nyla, Fuse ODG	Light It Up (feat. Nyla & Fuse ODG [Remix])	spotify:track:4kCmfCnNjca59NowllKhzV

La Que Me Gusta	Los Amigos Invisibles	Repeat After Me	spotify:track:6AGh8CJ0jhJXmNgxzCH6P8

Desde Que	Liquits	Jardin	spotify:track:4QLfVqOrpBOJra53EhlEX0

Love Yourself	Justin Bieber	Purpose (Deluxe)	spotify:track:50kpGaPAhYJ3sGmk6vplg0

Sorry	Justin Bieber	Purpose (Deluxe)	spotify:track:09CtPGIpYB4BrO8qb1RGsF

Hello	Adele	Hello	spotify:track:0ENSn4fwAbCGeFGVUbXEU3

What Do You Mean?	Justin Bieber	What Do You Mean?	spotify:track:6nRwc5GgNvBMkKaynhQzrm

Cheerleader (feat. Kid Ink) - Felix Jaehn vs Salaam Remi Remix	OMI, Kid Ink	Cheerleader (feat. Kid Ink) [Felix Jaehn vs Salaam Remi Remix]	spotify:track:73mE3nfR4jSuJMGHmcGOlp

One Dance	Drake, WizKid, Kyla	One Dance	spotify:track:11hqMWwX7sF3sOGdtijofF

This Is What You Came For	Calvin Harris, Rihanna	This Is What You Came For	spotify:track:0azC730Exh71aQlOt9Zj3y

Middle	DJ Snake, Bipolar Sunshine	Middle	spotify:track:2bKhIGdMdcqCqQ2ZhSv5nE

Faded	Alan Walker	Faded	spotify:track:1brwdYwjltrJo7WHpIvbYt

Work from Home	Fifth Harmony, Ty Dolla $ign	Work from Home	spotify:track:0SJPThTy7ynySPF4euczx7

La Bicicleta	Carlos Vives, Shakira	La Bicicleta	spotify:track:43it4kot08akLzFIEMhXNN

Sex	Cheat Codes, Kris Kross Amsterdam	Sex	spotify:track:4tRLfSHpbjlIjV97RPWr9Y

I Took A Pill In Ibiza - Seeb Remix	Mike Posner	The Truth (Remixes)	spotify:track:7HzCxalzzYQOFb9a7Xs3j6

CAN'T STOP THE FEELING! (Original Song from DreamWorks Animation's "TROLLS")	Justin Timberlake	CAN'T STOP THE FEELING! (Original Song from DreamWorks Animation's "TROLLS")	spotify:track:6JV2JOEocMgcZxYSZelKcc

Adventure of a Lifetime	Coldplay	A Head Full of Dreams	spotify:track:69uxyAqqPIsUyTO8txoP2M

I Think I Like It	Fake Blood	Fix Your Accent	spotify:track:2vClCBvGKJOxhhtw71Dobw

Desire - Gryffin Remix	Years & Years, Gryffin	Desire (Gryffin Remix)	spotify:track:6JzCO4ZzxAXhY86vTcqM1Q

I Can Be Somebody (feat. Erin McCarley)	Deorro, Erin McCarley	I Can Be Somebody (feat. Erin McCarley)	spotify:track:0sxvPuybHVMwEvCSfbJDM6

Sunlight (feat. Years and Years) - Radio Edit	The Magician, Years & Years	Sunlight (feat. Years & Years) [Radio Edit]	spotify:track:5r3aYGutXgsxSqB6W3RrzJ

Firestone (feat. Conrad Sewell)	Kygo, Conrad Sewell	Firestone (feat. Conrad Sewell)	spotify:track:2sNvitW3TxiTeC9xT9f2ZZ

Where Are Ü Now (with Justin Bieber)	Jack Ü, Skrillex, Diplo, Justin Bieber	Skrillex and Diplo present Jack Ü	spotify:track:66hayvUbTotekKU3H4ta1f

I Feel Alive - English Version	CD9	I Feel Alive (English Version)	spotify:track:5AEwexlrUvsvHK5IcIt9SL

It's Time	Imagine Dragons	Night Visions	spotify:track:6BtmXhTJMM9sBTHeYYASGz

Burn	Ellie Goulding	Halcyon Days	spotify:track:0xMd5bcWTbyXS7wPrBtZA6

S&M	Rihanna	Loud	spotify:track:0C4ejWmOTMv8vuYj85mf8m

Waves - Robin Schulz Radio Edit	Mr. Probz, Robin Schulz	Waves (Robin Schulz Radio Edit)	spotify:track:5Sf3GyLEAzJXxZ5mbCPXTu

Blank Space	Jessica Lovelace	Workout Jams	spotify:track:7CBmUHoxtzrWFHVeyGAggv

Locked Away	R. City, Adam Levine	What Dreams Are Made Of	spotify:track:7x5xYW5W42OGPAdHUyyguy

Close	Nick Jonas, Tove Lo	Close	spotify:track:2LbbLV26X7K1kLzI7xXFE2

All About That Bass	Meghan Trainor	All About That Bass	spotify:track:0ifSeVGUr7py5GggttDhXw

Ain't Nobody (Loves Me Better)	Felix Jaehn, Jasmine Thompson	Ain't Nobody (Loves Me Better)	spotify:track:3vbqb78xzvD3CJl7ZeW83c

Love Me Like I Do - Remake Remix to Ellie Goulding	SteLa	Ladies Pop 2015	spotify:track:3JAlQlsGyBf4x0nkovBXdn

Marvin Gaye	Charlie Puth, Meghan Trainor	Some Type Of Love	spotify:track:6ukMqDxnOPOgoHdak7Kyp3

I Don't Like It, I Love It (feat. Robin Thicke & Verdine White)	Flo Rida, Robin Thicke, Verdine White	My House	spotify:track:2S5LNtRVRPbXk01yRQ14sZ

Thinking out Loud	Ed Sheeran	x (Deluxe Edition)	spotify:track:34gCuhDGsG4bRPIf9bb02f

Love Me Like You Do - From "Fifty Shades Of Grey"	Ellie Goulding	Love Me Like You Do (From "Fifty Shades Of Grey")	spotify:track:7y2YUIyCuVhBidENVT0068

Same Old Love	Selena Gomez	Revival (Deluxe)	spotify:track:6ZANrVuAMp2rpjhfbOuJly

All of Me	John Legend	Love In The Future (Expanded Edition)	spotify:track:3U4isOIWM3VvDubwSI3y7a

Worth It	Fifth Harmony, Kid Ink	Reflection (Deluxe)	spotify:track:41Fflg7qHiVOD6dEPvsCzO

Someone Like You	Adele	21	spotify:track:6QPKYGnAW9QozVz2dSWqRg

Set Fire to the Rain	Adele	21	spotify:track:5PKWUDfQFtc5qqo8cs1gQp

Treasure	Bruno Mars	Unorthodox Jukebox	spotify:track:55h7vJchibLdUkxdlX3fK7

Marry You	Bruno Mars	Doo-Wops & Hooligans	spotify:track:6SKwQghsR8AISlxhcwyA9R

Demons	Imagine Dragons	Night Visions (Deluxe)	spotify:track:2Oehrcv4Kov0SuIgWyQY9e

This Summer	Maroon 5	V (Deluxe)	spotify:track:5NUlOzzMdoIABFTnhizCQa

Try	P!nk	Los Nº1 de 40 Principales (2013)	spotify:track:6s9jkCVw3K7x0LcAnnDECj

Blow Me (One Last Kiss)	P!nk	The Truth About Love	spotify:track:4k80K0b6KZ2QjAYkXON7q6

Only Girl (In The World)	Rihanna	Loud	spotify:track:0AH6WMe3OlAlUb5miXt2FQ

Diamonds	Rihanna	Unapologetic (Deluxe)	spotify:track:6O20JhBJPePEkBdrB5sqRx

Heart Attack	Demi Lovato	Demi (Deluxe)	spotify:track:0P0MAfMdy2j8Z2EYqMkL3X

Anything Could Happen	Ellie Goulding	Halcyon Days	spotify:track:3nonEISr5tui8o4UF9XXfM

FourFiveSeconds	Rihanna, Kanye West, Paul McCartney	FourFiveSeconds	spotify:track:5XzmZjXhMjDHr7ZfJ6DELQ

El Primer Día del Resto de Mi Vida - Directo Primera Fila	La Oreja de Van Gogh	Primera Fila	spotify:track:3ozuHMral4k7ALNOgPdxQ8

Teenage Dream	Katy Perry	Katy Perry - Teenage Dream: The Complete Confection	spotify:track:55qBw1900pZKfXJ6Q9A2Lc

Roar	Katy Perry	PRISM (Deluxe)	spotify:track:3bDGwl0X3EjQmIyFD1uif5

Firework	Katy Perry	Katy Perry - Teenage Dream: The Complete Confection	spotify:track:4lCv7b86sLynZbXhfScfm2

The Monster	Eminem, Rihanna	The Marshall Mathers LP2 (Deluxe)	spotify:track:5U8hKxSaDXB8cVeLFQjvwx

We Don't Talk Anymore	Charlie Puth, Selena Gomez	Nine Track Mind	spotify:track:06KyNuuMOX1ROXRhj787tj

I Still Haven't Found What I'm Looking For - Remastered 2007	U2	The Joshua Tree	spotify:track:72AO8u6lcjKp0CBeaPZT8I

Roar	Katy Perry	PRISM	spotify:track:27tNWlhdAryQY04Gb2ZhUI

Little Bitty Pretty One	Thurston Harris	Little Bitty Pretty One	spotify:track:2kdN469Fa1LKzCEpF7fK8U

I'm So Excited	The Pointer Sisters	Best Of	spotify:track:2u8MGAiS2hBVE7GZzTZLQI

Pumped Up Kicks	Foster The People	Torches	spotify:track:7w87IxuO7BDcJ3YUqCyMTT

Summer	Calvin Harris	Summer	spotify:track:7b71WsDLb8gG0cSyDTFAEW

You're The One That I Want	John Travolta, Olivia Newton-John	Grease	spotify:track:1pViOt8zA2rl2NfHeDGnyD

The Way You Make Me Feel - Remastered Version	Michael Jackson	Michael Jackson's This Is It	spotify:track:2MktNn429Sn1p4FjZjOM39

Sweet Lovin' (feat. Bryn Christopher) - Re-Edit	Sigala, Bryn Christopher	Sweet Lovin' (EP) (feat. Bryn Christopher)	spotify:track:120ZopRv5Na8WIiXxa2qwS

Same Love - feat. Mary Lambert	Macklemore & Ryan Lewis, Mary Lambert	The Heist	spotify:track:01uqI4H13Gsd8Lyl1EYd8H

Heathens	Twenty One Pilots	Suicide Squad: The Album	spotify:track:3vZM2544ETmOCCHuBPZRzm

You Don't Own Me (feat. G-Eazy)	SAYGRACE, G-Eazy	Suicide Squad: The Album	spotify:track:6Slaf2WBzQA86oS7MNMUNS

Without Me	Eminem	Suicide Squad: The Album	spotify:track:1dWXQWIjjYWafYgw0zVGnG

Bohemian Rhapsody	Panic! At The Disco	Suicide Squad: The Album	spotify:track:2YSbHu9XF4bNYWt3MnIhgE

Ain't Your Mama	Jennifer Lopez	Ain't Your Mama	spotify:track:2hgzdQdnfWwtdpZbhZlV72

Final Song	MØ	Final Song	spotify:track:4qqArAiTPueDxIp7cf87h7

Treat You Better	Shawn Mendes	Treat You Better	spotify:track:53B2XmmjJ9rriW1qciMBeX

Work from Home (feat. Ty Dolla $ign)	Fifth Harmony, Ty Dolla $ign	7/27 (Deluxe)	spotify:track:4tCtwWceOPWzenK2HAIJSb

7 Years	Lukas Graham	Lukas Graham	spotify:track:5kqIPrATaCc2LqxVWzQGbk

Tu Falta De Querer	Mon Laferte	Mon Laferte (Vol. 1)	spotify:track:4skuEIloXWuxxgekKupkEH

Amor Completo	Mon Laferte	Mon Laferte (Vol. 1)	spotify:track:00kIWJu9IHiQ6i0qJAU0Z9

Lo Mejor de Mi Vida Eres Tú (feat. Natalia Jiménez)	Ricky Martin, Natalia Jiménez	Personalidad	spotify:track:42uoASVTqZQO8OLBtLtg8x

Mi Persona Favorita	Río Roma	Otra Vida	spotify:track:70fVcEP5pRrxaIICY3DcPe

Closer	The Chainsmokers, Halsey	Closer	spotify:track:7BKLCZ1jbUBVqRi2FVlTVw

Let Me Love You	DJ Snake, Justin Bieber	Encore	spotify:track:4pdPtRcBmOSQDlJ3Fk945m

Cold Water (feat. Justin Bieber & MØ)	Major Lazer, Justin Bieber, MØ	Cold Water (feat. Justin Bieber & MØ)	spotify:track:6DNtNfH8hXkqOX1sjqmI7p

Ride	Twenty One Pilots	Blurryface	spotify:track:2Z8WuEywRWYTKe1NybPQEW

This Girl - Kungs Vs. Cookin' On 3 Burners	Kungs, Cookin' On 3 Burners	This Girl (Kungs Vs. Cookin' On 3 Burners)	spotify:track:4AOpEhqA7zHxQjkHmRrAp7

Borro Cassette	Maluma	Pretty Boy, Dirty Boy	spotify:track:6DUdDIRgLqCGq1DwkNWQTN

Perfect Strangers	Jonas Blue, JP Cooper	Perfect Strangers	spotify:track:1CUVN2kn7mW5FjkqXTR2W1

Eres Mía	Romeo Santos	Fórmula, Vol. 2 (Deluxe Edition)	spotify:track:6I86RF3odBlcuZA9Vfjzeq

Propuesta Indecente	Romeo Santos	Fórmula, Vol. 2 (Deluxe Edition)	spotify:track:5PycBIeabfvX3n9ILG7Vrv

Yo También	Romeo Santos, Marc Anthony	Fórmula, Vol. 2 (Deluxe Edition)	spotify:track:5A9AILetvfQg3LHyX5X0pV

Vente Pa' Ca	Ricky Martin, Maluma	Vente Pa' Ca	spotify:track:7DM4BPaS7uofFul3ywMe46

La Mordidita	Ricky Martin, Yotuel	A Quien Quiera Escuchar (Deluxe Edition)	spotify:track:00i0O74dXdaKKdCrqHnfXm

Adiós	Ricky Martin	A Quien Quiera Escuchar (Deluxe Edition)	spotify:track:13FdGdz4KnwH8UIX5JxO8r

Traicionera	Sebastian Yatra	Traicionera	spotify:track:5J1c3M4EldCfNxXwrwt8mT

La Bicicleta - Remix	Carlos Vives, Shakira, Maluma	La Bicicleta (Remix)	spotify:track:7IRuf7FrdQvOGs0g9mSNGr

La llorona	Chavela Vargas	La Llorona	spotify:track:45rQqSqb95p5lkZy13Tl1u

Me, Myself & I	G-Eazy, Bebe Rexha	When It's Dark Out	spotify:track:40YcuQysJ0KlGQTeGUosTC

Chantaje	Shakira, Maluma	Chantaje	spotify:track:1WniHvhq9zTkny0WvGXX8o

Cancioncitas de Amor	Romeo Santos	Fórmula, Vol. 2 (Deluxe Edition)	spotify:track:6bcdiJvYNX115yvbh3wASz

Desde Esa Noche	Thalía, Maluma	Desde Esa Noche	spotify:track:7cJaRc4y64x0YWBJmpRzO2

Baila Conmigo	Juan Magán, Luciana	Baila Conmigo	spotify:track:7LzkDsLUicGxxvlbzQFN9f

Magalenha	Sérgio Mendes	Brasileiro	spotify:track:1KhskNApqcI0XuIbbeERlw

Hasta el Amanecer	Nicky Jam	Hasta el Amanecer	spotify:track:4wFHfY9IILHLNwakPuFogD

Safari	J Balvin, Pharrell Williams, BIA, Sky	Energía	spotify:track:456xBIOmLRoLzCvCzZrWge

Amor, Amor, Amor	Paty Cantú	Amor, Amor, Amor	spotify:track:1fiMRK6CLTvhErCJm9lsE9

Perdido En Tus Ojos	Don Omar, Natti Natasha	Perdido En Tus Ojos	spotify:track:0w43hzUIIMeSzlCgCC41uX

Side To Side	Ariana Grande, Nicki Minaj	Dangerous Woman	spotify:track:1pKeFVVUOPjFsOABub0OaV

Shake It Off	Twenty One Two	Shake It Off (Orig. by Taylor Swift)	spotify:track:1j2sRZpFUzG6wPJGfRvet3

Creo en Ti	Reik	Peligro	spotify:track:0FHNqVPxu14WivXR4Y2hFr

Love Never Felt So Good	Michael Jackson, Justin Timberlake	XSCAPE	spotify:track:48td6xvpokdYwvbl3JIiXP

Stitches	Shawn Mendes	Handwritten (Revisited)	spotify:track:5t4B1kAlCD13YY9poph0Mg

Treat You Better	Shawn Mendes	Illuminate (Deluxe)	spotify:track:1rtDwblY1CJ9i490fMzJnc

I'm Yours	Jason Mraz	We Sing. We Dance. We Steal Things.	spotify:track:1EzrEOXmMH3G43AXT1y7pA

La flaca	Jarabe De Palo	La Flaca - Edición 10º Aniversario	spotify:track:1MrZ8hGkUWMmT816wPaMgE

No soy una de esas (feat. Alejandro Sanz)	Jesse & Joy, Alejandro Sanz	Un Besito Más	spotify:track:3QjkcFDVHOB4Z43esP5A8N

Japi	Sasha, Benny y Erik	Vuelta al Sol	spotify:track:3VhqlPwdb8WGdiPOj4D5DE

Más alto que nosotros sólo el cielo	Bunbury	Palosanto	spotify:track:1FdU4MHZvtVraJgnccMd16

Pervert Pop Song	Plastilina Mosh	All U Need Is Mosh	spotify:track:1dkGPPewLZjer3U2pQGIOK

El Perdedor	Maluma	Pretty Boy, Dirty Boy	spotify:track:1iEwyiSLAunPR6uouANE0O

El Perdedor	Enrique Iglesias, Marco Antonio Solís	SEX AND LOVE (Deluxe)	spotify:track:4jMu6QYon1JEikcdTJ1TzR

Convéncete, Convénceme	Crónicas Del Mar	Convéncete, Convénceme	spotify:track:3j1OnmQd2SV4kTD5D9KmVR

Nothing Else Matters/Despedida Medley (Live From Paris) - Live Version	Shakira	Live From Paris	spotify:track:1GBe2Gnd29NfbbHfn30xPM

Shaky Shaky	Daddy Yankee	Shaky Shaky	spotify:track:7gcMKL3lnDxsp4bIXyv6Zk

Pajarito Del Amor (Dueto Con Natalia Lafourcade)	Carla Morrison	Mientras Tú Dormías	spotify:track:5FAWhdBOfdfSPeG003rxrp

Pajarito Del Amor (Dueto Con Natalia Lafourcade)	Carla Morrison	Mientras Tú Dormías	spotify:track:5FAWhdBOfdfSPeG003rxrp

Estrellas Rotas	Kalimba	Cena para Desayunar	spotify:track:5OeCxTOOl8N4FAUNZmw4Va

Otra vez (feat. J Balvin)	Zion & Lennox, J Balvin	Otra Vez (feat. J Balvin)	spotify:track:7pk3EpFtmsOdj8iUhjmeCM

Andas En Mi Cabeza	Chino & Nacho, Daddy Yankee	Andas En Mi Cabeza	spotify:track:23WI5V2eD4EyGKxSl7Pyeq

Ay MI Dios (feat. Pitbull, Yandel & Chacal)	IAmChino, Pitbull, Yandel, El Chacal	Ay MI Dios (feat. Pitbull, Yandel & Chacal)	spotify:track:6ixvuvnE27lFE2SvCXpWce

Compartir	Carla Morrison	Mientras Tú Dormías	spotify:track:5E0Jl45E0UWwZ4H9VhnI9i

Back It Up - Spanish Version	Prince Royce, Jennifer Lopez, Pitbull	Back It Up (Spanish Version)	spotify:track:20O2E1JUPkYzplbBccP231

Me Llamas (feat. Maluma) - Remix	Piso 21, Maluma	Me Llamas (feat. Maluma) [Remix]	spotify:track:5hEM0JchdVzQ5PwvSfITeX

I Feel It Coming	The Weeknd, Daft Punk	Starboy	spotify:track:3dhjNA0jGA8vHBQ1VdD6vV

Brillas	León Larregui	Solstis - De León Larregui	spotify:track:6VuUMo1TusnqBxLTnr3hOI

Three Little Birds	Bob Marley & The Wailers	Legend (Deluxe Edition)	spotify:track:26JRni5Lqiyd9GNnlaz6DI

Pasos de cero	Pablo Alborán	Terral	spotify:track:18mmN3VrFWRi6SsSBJf6WJ

Despacito (Featuring Daddy Yankee)	Luis Fonsi, Daddy Yankee	Despacito (Featuring Daddy Yankee)	spotify:track:4aWmUDTfIPGksMNLV2rQP2

Uno X Uno	Manuel Carrasco	Bailar El Viento	spotify:track:75K7Mczlt0zxANo8MEOaAu

Gyal You a Party Animal	Charly Black	Latino Stars 2016: The Best of Reggaeton, Salsa, Kizomba & Bachata	spotify:track:5Q9G8zEq4KOm4xTqF0Lqev

Odio	Romeo Santos, Drake	Fórmula, Vol. 2 (Deluxe Edition)	spotify:track:1iLv1ieT9BZ3qsti9yTCnG

Llegaste tú (feat. Reykon)	Sofia Reyes, Reykon	Louder!	spotify:track:79Bm3DTEYuQsDpUVHbSRsL

Shape of You	Ed Sheeran	Shape of You	spotify:track:0FE9t6xYkqWXU2ahLh6D8X

Te Juro	Samo, Alejandra Guzman	Te Juro	spotify:track:3CjXxqVfO1sqJjSDcEqm7x

Vete, Vete	Matisse	Sube (Summer Edition)	spotify:track:74E7sYzOKrS1QLu5KPej4r

Bohemian Rhapsody - Live	Queen	Hungarian Rhapsody (Live In Budapest / 1986)	spotify:track:5WnIPc9cBMENPkxIlESu7y

Pégate (MTV Unplugged Version)[Radio Edit]	Ricky Martin	Ricky Martin MTV Unplugged	spotify:track:6derJzyW5gcu125FpbsReh

Me Enamoré	Shakira	Me Enamoré	spotify:track:4m5A5meIueOcDBpbqGvkQB

Felices los 4	Maluma	Felices los 4	spotify:track:0qYTZCo5Bwh1nsUFGZP3zn

Amárrame	Mon Laferte, Juanes	Amárrame	spotify:track:0jTJlKUegj0w7crcxzxqhj

Me Rehúso	Danny Ocean	Me Rehúso	spotify:track:6Zosz8w6CmdGMZM6p4JlbQ

I Apologise (Dear Simon)	Moss	Never Be Scared / Don't Be A Hero	spotify:track:697SxVVl5riHJAHqeVuZoc

Hey Ma (with Pitbull & J Balvin feat. Camila Cabello) - Spanish Version	Pitbull, J Balvin, Camila Cabello	Hey Ma (with Pitbull & J Balvin feat. Camila Cabello) [Spanish Version]	spotify:track:6DRGwsUFQrNerxRexK7KMB

Mi Gente	J Balvin, Willy William	Mi Gente	spotify:track:4ipnJyDU3Lq15qBAYNqlqK

Bad Liar	Selena Gomez	Bad Liar	spotify:track:2fZQIJew3nkNe99s2PKzul

No digas nada	Mario Bautista	No Digas Nada	spotify:track:1RwoXmQ3RvIdfG8bLeX65g

Havana	Camila Cabello, Young Thug	Havana	spotify:track:0ofbQMrRDsUaVKq2mGLEAb

Sign of the Times	Harry Styles	Sign of the Times	spotify:track:5ELRkzdzz0HvGpMDlfZHkV

Swalla (feat. Nicki Minaj & Ty Dolla $ign)	Jason Derulo, Nicki Minaj, Ty Dolla $ign	Swalla (feat. Nicki Minaj & Ty Dolla $ign)	spotify:track:6kex4EBAj0WHXDKZMEJaaF

Prometiste - MTV Unplugged [En Vivo]	Pepe Aguilar, Ángela Aguilar, Melissa, La Marisoul	Pepe Aguilar MTV Unplugged [(MTV Unplugged) [En Vivo]]	spotify:track:4UuVcf9nvpqyPsOk0P9oBH

You're The One That I Want	Lo-Fang	Blue Film	spotify:track:1dEHQktvcM8vCCyI1x7yVB

A Thousand Years	Christina Perri	A Thousand Years	spotify:track:6lanRgr6wXibZr8KgzXxBl

Entre Palmeras	La Garfield	Entre Palmeras	spotify:track:3nHM8pYoPXKMuI20gwGtfj

Learn to Fly	Foo Fighters	There Is Nothing Left To Lose	spotify:track:5OQsiBsky2k2kDKy2bX2eT

No Es Justo	J Balvin, Zion & Lennox	No Es Justo	spotify:track:1RTlTuLOdnmgbe11ynwR7c

Perfect	Ed Sheeran	÷ (Deluxe)	spotify:track:0tgVpDi06FyKpA1z0VMD4v

Runnin' (Lose It All)	Naughty Boy, Beyoncé, Arrow Benjamin	Runnin' (Lose It All)	spotify:track:5yZvaUVyuXfSVUaMumFi6l

Stayin' Alive - From "Saturday Night Fever" Soundtrack	Bee Gees	Tales From The Brothers Gibb	spotify:track:79hJaqmVdohltPBNN6BULM

How Deep Is Your Love - From "Saturday Night Fever" Soundtrack	Bee Gees	Tales From The Brothers Gibb	spotify:track:1W9zants12SLSVJE2QPYij

Calma - Remix	Pedro Capó, Farruko	Calma (Remix)	spotify:track:5iwz1NiezX7WWjnCgY5TH4

I'm On Fire	Big Z, Ameria	I'm On Fire	spotify:track:617k4ZiNUePgF7akUlPovE

Fantasy	Black Box	Dreamland	spotify:track:6aKxDL6KiKCHYsQyDq7Vgd

Déjala Que Vuelva (feat. Manuel Turizo)	Piso 21, Manuel Turizo	Ubuntu	spotify:track:1j6xOGusnyXq3l6IryKF3G

Disfruto - (Carla Morrison By Napy Remix)	Napy	Disfruto (Carla Morrison By Napy Remix)	spotify:track:7qX6paE9y4ZS8oAuasmoFo

Baila Conmigo (feat. Kelly Ruiz)	Dayvi, Victor Cardenas, Kelly Ruíz	Baila Conmigo (feat. Kelly Ruiz)	spotify:track:4Clmg1g8n2yBYG13Z1oSdG

Con Altura	ROSALÍA, J Balvin, El Guincho	Con Altura	spotify:track:2qG5sZ7Si6sdK74qLxedYM

Playa y Arena (Remix)	Mark B., Gabriel, Ozuna	Playa y Arena (Remix)	spotify:track:4Q6Z7fn2xVhPZ1xn0XfEOY



Heimweh	Heike Blau	Heimweh	spotify:track:1qnQqvSMiErQ7WWt1nYm7R

supine	Teodor Wolgers	hopes	spotify:track:7IMGJM5S0YYcQhvtdeJH14

Look Up to the Sky	Edvard Kravchuk	Look Up to the Sky	spotify:track:6xW68JTOivTwIp1IQZlwG6

Fairfield	Isaac Nash	Fairfield	spotify:track:2sc04X1Z2uVblrt7zqHSYS

Uitwaaien	Juultje Berben	Uitwaaien	spotify:track:6fOFKyLhs5ryi2f8IiWBq8

Den första snön	Maya Åström	Den första snön	spotify:track:64yTTGTPOZos3UEouvO6tp

Lamentation For A Lost Life	Max Richter	Taboo (Music From The Original TV Series)	spotify:track:77O9eTcQpYwCnANBQHjGDQ

Norrsken	Karin Borg	Norrsken	spotify:track:3toYHht60pj16nNK0e2HZy

Daybreak	Francie Stooge	Daybreak	spotify:track:0xOPyF2d1FC6xuBRj3JJxN

Timelapse	Minnie Scolanti	Timelapse	spotify:track:1AyZlUfEdW8pBzILc2Zd5D

Floating	Way Beyond	Floating	spotify:track:1fcPVf8Rqckxy4wxC4vYoz

Pachm	Aenor	Pachm	spotify:track:5399qRI8W27gFhEdl0WYST

In a Bar in Buenos Aires	Franz Gordon	In a Bar in Buenos Aires	spotify:track:5C4t6U8yLBmG5xbUhJ205E

Indigo	Biba Dupont	Indigo	spotify:track:0VFt2URvZYKAqFVMhZADBG

The Winding Paths	Regina Mira	October	spotify:track:5VceRZmSDeW6y7ipxiwOvK

Les Etudes	Mark Souzek	Les Etudes	spotify:track:57YVVhWcChlS42r0EmA9aT

That day	Leroy Bolander	That day	spotify:track:6pvG7rCh9GQQTWUCkPVjDB

Hand in Hand	Kozue Ojima	Hand in Hand	spotify:track:3nRbOaWAsIEIUFkFRlYVAM

Connected Colors (Solo Piano Version)	Piano Novel	Connected Colors	spotify:track:73Q5VDA6CXofjBtGGWEZEQ

Nel bisogno si riconosce il vero amico	Fioretta Rizzo	Nel bisogno si riconosce il vero amico	spotify:track:1rUG0qJbwGySkGj9yd1GuJ

Sail	Roman Jensen	Sail	spotify:track:5n5E3SxEh2Wt2WSIyW20Ly

Hiemal	Maria Marble	Hiemal	spotify:track:72mTEG6Cw5amIPeNtOTzGV

For Stormboy	Rhiannon Bannenberg	Ambrosia (Official Soundtrack)	spotify:track:1gLbbnyTOnx6LrCQ87c0gp

Downstreams	Max Swan	Downstreams	spotify:track:0PfQd8JoZTLC7QmuSALrnH

Preludium	Karin Borg	Preludium	spotify:track:5V1fERRi9CKUG4lkeAP9Ue

Abstract	Juliet Moss	Abstract	spotify:track:6Ae3iWVP4x55cr0VywHQne

Take Me Somewhere Else	Eik Octobre	Take Me Somewhere Else	spotify:track:37EJ2kCLr8RoXDxYE5cHrF

A Letter Home	Berlioz	A Letter Home	spotify:track:5CG4KWy5qqSnv62DmMjTrH

Aion	Kolorascze	Aion	spotify:track:09aXsDzTB0HxnZw6zvKwqf

Plus tôt	Alexandra Streliski	Plus tôt	spotify:track:3ODEuZjfxec5fYnzVhxANv

Resilient	Robin Bennich	Resilient	spotify:track:3qcqLrOeFOaWzpHK7GK6Qo

Dust	Verinda	Dust	spotify:track:65D1Dr0vNzYruUkQu8Jt5j

Sweetest Dreams	Eamonn Watt	Sweetest Dreams	spotify:track:2Hbkoo2yD0GYiHxqKZv3td

Lucida	Odin Sørlie	Lucida	spotify:track:316nnoeN99STxwMJWNnH0a

Shouganai	Jitka Kubr	Shouganai	spotify:track:2fKUHlU2YvmZbSi0DVWA8A

Qui vivra verra	Dagmar Collier	Qui vivra verra	spotify:track:6gfs2xM6OXGyzTsRxB2RNL

Back Home	Moux	Gaze	spotify:track:1pgSiIvNXVQAKlMvjvqL0r

Wolfpack	Johannes Bornlöf	Dear Sleep	spotify:track:2uaSFwufXiS5OuuN4sqFGv

Whenever You Are With Me	Aron Risa	Whenever You Are With Me	spotify:track:2E4e5HgV9h58cJdYcZpEX0

Solitaire	Christopher Dicker	Solitaire	spotify:track:7jYOivheBtZYcsnJhQOMXT