track_name	artist_name	album_name	track_uri
Moondust	Jaymes Young	Dark Star EP	spotify:track:4kzyhn8i6Hf8daEBqNPfCy

Another Love	Tom Odell	Long Way Down (Deluxe)	spotify:track:3JvKfv6T31zO0ini8iNItO

All of Me	John Legend	Love In The Future (Expanded Edition)	spotify:track:3U4isOIWM3VvDubwSI3y7a

Cleopatra	The Lumineers	Cleopatra	spotify:track:5bzf1xrbqr1ttjAJuRz2xY

Ophelia	The Lumineers	Cleopatra	spotify:track:5NORWMFC27ywGSZxi8uquP

Stolen Dance	Milky Chance	Sadnecessary	spotify:track:2jiPHbFX5XM8TjaTfYJ0eo

Clocks	Coldplay	A Rush of Blood to the Head	spotify:track:0BCPKOYdS2jbQ8iyB56Zns

Sparrow	Tom Odell	Wrong Crowd (Deluxe)	spotify:track:550yFOAQr0gfOa69IMixoM

Dive	Ed Sheeran	√∑ (Deluxe)	spotify:track:51ChrwmUPDJvedPQnIU8Ls

Bubble Gum	Clairo	Bubble Gum	spotify:track:3zksbXteOCeSusJ5Xltr3t

Cigarette Daydreams	Cage The Elephant	Melophobia	spotify:track:6EThJr4Dq1Y93JspecGU2F

Moondust - Stripped; EP Version	Jaymes Young	Habits Of My Heart EP	spotify:track:3mBCTEzhxcv6jLaxXoOvWs

Eu Sei	Papas Da L√≠ngua	Papas Da L√≠ngua	spotify:track:5YQPOIAt3U7DMAswTVvzax

Again	Noah Cyrus, XXXTENTACION	Again	spotify:track:2S2od3hT7ceytw7d1pTRuE

Jocelyn Flores	XXXTENTACION	17	spotify:track:7m9OqQk4RVRkw9JJdeAw96

Dancin (feat. Luvli) - Krono Remix	Aaron Smith, Krono, Luvli	Dancin (feat. Luvli) [Krono Remix]	spotify:track:6WkJ2OK163XXS2oARUC9JM

Vermilion, Pt. 2	Slipknot	Vol. 3: The Subliminal Verses	spotify:track:0O7lENhqOySbsL743G7PqD

Two Hearts and No Brain	Kane Strang	Two Hearts and No Brain	spotify:track:0dQQSSIusYHPmzayfCKBxF

Honest	The Neighbourhood	The Amazing Spider-Man 2 (The Original Motion Picture Soundtrack)	spotify:track:1FjjWOms0Nx8YbpQ7BBKDR

Snuff	Slipknot	All Hope Is Gone (10th Anniversary)	spotify:track:2vPZ4Lklyu75zBR3SgbFNI

The Night We Met	Lord Huron	Strange Trails	spotify:track:6mORGLOz79w6VsCRLWYYuK

Infinity	Jaymes Young	Feel Something	spotify:track:1SOClUWhOi8vHZYMz3GluK

Feel Something	Jaymes Young	Feel Something	spotify:track:0vMI3AJPQMjytAu8XMWr65

Black Magic	Jaymes Young	Feel Something	spotify:track:7drLhxwt6idqexeSk4Zuf4

Sweater Weather	Kurt Hugo Schneider, Alyson Stoner, MAX	Kurt & Company Vol 2	spotify:track:0kn9QwZW8Ow9eTuZgxVEz8

I Follow Rivers - The Magician Remix	Lykke Li, The Magician	I Follow Rivers (The Magician Remix)	spotify:track:4Jv7lweGIUOFQ7Oq2AtAh9



üò≠ üò≠ üò≠ 

Boulevard of Broken Dreams (feat. John Gallagher Jr., Rebecca Naomi Jones, Stark Sands, Company)	Green Day	American Idiot - The Original Broadway Cast Recording Featuring Green Day	spotify:track:41pFyxOpS119Pb8JEzhx0w

human	Christina Perri	human	spotify:track:1zVhMuH7agsRe6XkljIY4U

Let Her Go	Passenger	All The Little Lights	spotify:track:2jyjhRf6DVbMPU5zxagN2h

Me And My Broken Heart	Rixton	Me And My Broken Heart	spotify:track:2rJojRundKuKFgbvmCAYva

The Reason	Hoobastank	The Reason	spotify:track:7afSN5zhUhkbpRFpYKYztK

I'm Not The Only One	Sam Smith	In The Lonely Hour (Drowning Shadows Edition)	spotify:track:5WLtenwEwifJHYTUw514RH

All I Want	Kodaline	In A Perfect World (Deluxe)	spotify:track:2jTidefcsTu6VQhpIImJrt

I Won't Give Up	Jason Mraz	I Won't Give Up	spotify:track:05pKAafT85jeeNhZ6kq7HT

Jar of Hearts	Christina Perri	lovestrong.	spotify:track:0HZhYMZOcUzZKSFwPOti6m

Someone Like You	Adele	21	spotify:track:6QPKYGnAW9QozVz2dSWqRg

Fix You	Coldplay	X&Y	spotify:track:7LVHVU3tWfcxj5aiPFEW4Q

Say Something	A Great Big World, Christina Aguilera	Is There Anybody Out There?	spotify:track:6Vc5wAMmXdKIAM7WUoEb7N

How to Save a Life	The Fray	How To Save A Life	spotify:track:5fVZC9GiM4e8vu99W0Xf6J

All of Me	John Legend	Love In The Future (Expanded Edition)	spotify:track:3U4isOIWM3VvDubwSI3y7a

Stay With Me	Sam Smith	In The Lonely Hour	spotify:track:5Db9VIdDsN5yu3Eu7CT0i4

When I Was Your Man	Bruno Mars	Unorthodox Jukebox	spotify:track:0nJW01T7XtvILxQgC5J7Wh

Endless Love	Lionel Richie, Shania Twain	Tuskegee	spotify:track:7nGSeNxEamdRjkQd3mDBwq

Ain't No Mountain High Enough	Marvin Gaye, Tammi Terrell	United	spotify:track:2H3ZUSE54pST4ubRd5FzFR

Stand by Me	Ben E. King	Don't Play That Song (Mono)	spotify:track:3SdTKo2uVsxFblQjpScoHy

Sway	Michael Bubl√©	Michael Bubl√©	spotify:track:2ajUl8lBLAXOXNpG4NEPMz

The Greener Side	Morgan Taylor Reid	A Minor Heartbeat	spotify:track:3TUk71Z8RiiWzegEpTdtDt

Overrated - Acoustic Version	MIKA	The Origin Of Love (Deluxe)	spotify:track:7BjDmv79RH0aguVCJdujuf

If You Go	Javier Dunn, Sara Bareilles	Trails	spotify:track:1sJEYAaax9yyR19akiTiTL

Oceans	Seafret	Oceans - EP	spotify:track:7Cia4WzapwjMr0NUQF8vf3

Á´•Ë©±	Michael Wong	Á´•Ë©±	spotify:track:4fjCxEyqYK4rorwQeWqvej

Chasing Cars	Snow Patrol	Chasing Cars	spotify:track:0rpIH5otu7ykvZPdcQuRPh

The Moon Song - Studio Version Duet	Karen O, Ezra Koenig	The Moon Song (Music From And Inspired By The Motion Picture Her) - Single	spotify:track:2Xzij2ym9ArSCvEKaQUJW2

Married Life (From "Up")	Mark Northam	Up: Music From The Pixar Films For Solo Piano	spotify:track:7KnFT8NQPRYtWOZXhWcGGZ

La Vie En Rose	Daniela Andrade	La Vie En Rose	spotify:track:0VxocBntP1XTZRsR9ZURPS

Creep	Daniela Andrade	Covers, Vol. 1	spotify:track:2hEQRGEAx4YKGh0Kg7djab

The A Team	Daniela Andrade	Covers, Vol. 1	spotify:track:6gfXhnL0FgMiFlt77c6f6v

Billie Jean	Daniela Andrade	Billie Jean	spotify:track:4spwpPKhuFed9huVCzhZqY

Storm (Forecass)	Jamie Foxx	Unpredictable	spotify:track:6M1IrI2xhLf5LCZ1jnU20L

Bright	Echosmith	Talking Dreams (Deluxe Version)	spotify:track:3WKg25vrbjJlkhsgl2W4p3

Careless Whisper	George Michael	Ladies And Gentlemen... The Best Of George Michael	spotify:track:4jDmJ51x1o9NZB5Nxxc7gY

The Show	Lenka	Lenka	spotify:track:6IfGxW1hRMUjjgVSDXwcAi

Talking to the Moon	Bruno Mars	Doo-Wops & Hooligans	spotify:track:1wVuPmvt6AWvTL5W2GJnzZ

Mad World (Feat. Michael Andrews)	Gary Jules, Michael Andrews	Trading Snakeoil for Wolftickets	spotify:track:3JOVTQ5h8HGFnDdp4VT3MP

ÈÇ£‰∫õÂπ¥	Hu Xia	ÈÇ£‰∫õÂπ¥,ÊàëÂÄë‰∏ÄËµ∑ËøΩÁöÑÂ•≥Â≠© ÈõªÂΩ±ÂéüËÅ≤Â∏∂	spotify:track:2MwjcKcekaSQyecQVkmGEw

Say You Won't Let Go	James Arthur	Say You Won't Let Go	spotify:track:1Pw5C4N6Fn5E4mGCxmbbVa

Let It Go	James Bay	Chaos And The Calm	spotify:track:40EB7ABUO6MoWMUwPKptJ7

The Man Who Can't Be Moved	The Script	The Script	spotify:track:4Musyaro0NM5Awx8b5c627

Love Me Now - Recorded at Spotify Studios NYC	John Legend	Spotify Singles	spotify:track:2pPRgFEENF3LtuxYUPuT24

Perfect	Ed Sheeran	√∑ (Deluxe)	spotify:track:0tgVpDi06FyKpA1z0VMD4v

Hotel California - 2013 Remaster	Eagles	Hotel California (2013 Remaster)	spotify:track:40riOy7x9W7GXjyGp4pjAv

Can't Help Falling in Love	Elvis Presley	Blue Hawaii	spotify:track:44AyOl4qVkzS48vBsbNXaC

Sweet Caroline	Neil Diamond	Sweet Caroline	spotify:track:3zByVQLvdXUaDTubfWkpCk

What's Up?	4 Non Blondes	Bigger, Better, Faster, More !	spotify:track:7f0jXNMu2xjQUtmKMuWhGA

You're Beautiful	James Blunt	Back to Bedlam	spotify:track:0vg4WnUWvze6pBOJDTq99k

Just Give Me a Reason (feat. Nate Ruess)	P!nk, Nate Ruess	The Truth About Love	spotify:track:1mKXFLRA179hdOWQBwUk9e

Mirrors	Justin Timberlake	The 20/20 Experience (Deluxe Version)	spotify:track:4rHZZAmHpZrA3iH5zx8frV



summer 19

One Man No City	Parquet Courts	Human Performance	spotify:track:1NdJo2IKt1NkVxAQNfZh47

WAKE UP	Travis Scott	ASTROWORLD	spotify:track:20MuVazoNMv6xjKPnRFOxG

Do That	Sheck Wes	Do That	spotify:track:3iVq1zq46q0auo3VwixXFe

I Cannot Fucking Wait Til Morrissey Dies	JPEGMAFIA	Veteran	spotify:track:0c81djsFYx69xCaNx4NHfH

Black Balloons Reprise	Flying Lotus, Denzel Curry	Flamagra	spotify:track:2csZLnXBMuw6ETZuRxdUZF

Puff Daddy	JPEGMAFIA, Kenny Beats	Puff Daddy	spotify:track:33omqR79fIXhaqdO4kQFAz

Live Sheck Wes	Sheck Wes	MUDBOY	spotify:track:1dhO5lyN2Otv4qR0xWQXH7

Like a Rolling Stone	Bob Dylan	Highway 61 Revisited	spotify:track:3AhXZa8sUQht0UEdBJgpGc

Top Off	Gunna	Drip Season 3 (Deluxe)	spotify:track:0HCnj7pfrvshnocOJUFeit

Rodeo	Lil Nas X, Cardi B	7 EP	spotify:track:4ak7xjvBeBOcJGWFDX9w5n

The London (feat. J. Cole & Travis Scott)	Young Thug, J. Cole, Travis Scott	The London	spotify:track:7DcvwMAiqKJQD1rrdfxSDx

Tilted	Christine and the Queens	Chaleur Humaine	spotify:track:2ILilOGEh31uHITYFazrLM

Sunflower - Spider-Man: Into the Spider-Verse	Post Malone, Swae Lee	Spider-Man: Into the Spider-Verse (Soundtrack From & Inspired by the Motion Picture)	spotify:track:3KkXRkHbMCARz0aVfEt68P

Juicy	Doja Cat	Amala (Deluxe Version)	spotify:track:4cTm3Ev9bUvy4ChJjB1nhl

101 FM	Little Simz	GREY Area	spotify:track:4Vk4Yf7pDmB1dxLFSTjBUH



trinity 19

Tenderness	Parquet Courts	Wide Awake!	spotify:track:2wF5p2dfUbEiqAnCRVNwmK

Mamacita	Travis Scott, Rich Homie Quan, Young Thug	Mamacita (feat. Rich Homie Quan & Young Thug)	spotify:track:3SEd8nPd8MpGwk6ZZ8tk2j

Enzo (with Sheck Wes, feat. Offset, 21 Savage & Gucci Mane)	DJ Snake, Sheck Wes, Offset, 21 Savage, Gucci Mane	Enzo (with Sheck Wes, feat. Offset, 21 Savage & Gucci Mane)	spotify:track:6mCqxnyOhr4tHMbRbQL4Yn

Kyrie	Sheck Wes	MUDBOY	spotify:track:3cT2KPDofP6iN0zfxAoALu

ZUU	Denzel Curry	ZUU	spotify:track:5sG65w8uKtjsJw7nc845Nc

Antidote	Travis Scott	Rodeo (Expanded Edition)	spotify:track:1wHZx0LgzFHyeIZkUydNXq

Antidote	Travis Scott	Rodeo (Expanded Edition)	spotify:track:1wHZx0LgzFHyeIZkUydNXq

That's Not Me	Skepta, Jme	Konnichiwa	spotify:track:3tTDOodJcr6vKF2DASlwMZ

The Times They Are A-Changin'	Bob Dylan	The Times They Are A-Changin'	spotify:track:52vA3CYKZqZVdQnzRrdZt6

Con Altura	ROSAL√çA, J Balvin, El Guincho	Con Altura	spotify:track:2qG5sZ7Si6sdK74qLxedYM

Faneto	Chief Keef	Chiraq Villian	spotify:track:6l4qV9VNeCOesvcLPJMO9y

Don't light my fire	Otoboke Beaver	ITEKOMA HITS	spotify:track:18ThXUp9jiQg26iD1w8reE



easter 19

Jumpers	Sleater-Kinney	The Woods	spotify:track:1Ekf4LfkzpVbwoUawE9R3E

Invincible	Amin√©	Spider-Man: Into the Spider-Verse (Soundtrack From & Inspired by the Motion Picture)	spotify:track:6VS7wKwtvL2FvTupYSWZ9e

Lithium - 1992/Live at Reading	Nirvana	Live at Reading	spotify:track:3tSlBGMPBJinIGolr8KOv9

Sandy	Rico Nasty	Sandy	spotify:track:2jK09xyR9psh1uhNQI40Rk

RICKY	Denzel Curry	RICKY	spotify:track:7K0iidDYDudSm9BoSt901M

The Fox	Sleater-Kinney	The Woods	spotify:track:1bnCl0lurjeZk8wtddHFYI

Tia Tamera (feat. Rico Nasty)	Doja Cat, Rico Nasty	Amala (Deluxe Version)	spotify:track:1uNePI826aqh9uC9pgbeHU



hilary 19

REEL IT IN	Amin√©	ONEPOINTFIVE	spotify:track:5qHirGR7M9tdm6C17DlzSY

SUMO | ZUMO	Denzel Curry	TA13OO	spotify:track:7EHAXZenBzmGCpccWCyg8z

Off Deez (with J. Cole)	JID, J. Cole	DiCaprio 2	spotify:track:3JAeYOjyJodI4PRs44lx2l

Westbrook (with A$AP Ferg)	JID, A$AP Ferg	DiCaprio 2	spotify:track:0GTzZhS8P50p922OEuoNLF

Foot Fungus	Ski Mask The Slump God	STOKELEY	spotify:track:3EikYy40GMSp8l5mDV6IQo

Mo Bamba	Sheck Wes	MUDBOY	spotify:track:1xzBco0xcoJEDXktl7Jxrr

Invincible	Amin√©	Spider-Man: Into the Spider-Verse (Soundtrack From & Inspired by the Motion Picture)	spotify:track:6VS7wKwtvL2FvTupYSWZ9e

Spice Girl	Amin√©	Good For You	spotify:track:4HW5kSQ8M2IQWZhSxERvla

Mixed Personalities (feat. Kanye West)	YNW Melly, Kanye West	We All Shine	spotify:track:6vWEAOUSxohKxhp0K1BsxL

a lot	21 Savage	i am > i was	spotify:track:2t8yVaLvJ0RenpXUIAC52d

We Appreciate Power	Grimes, HANA	We Appreciate Power	spotify:track:08ZCgkLKpcgrcSPCHN2v8J

Nowhere2go	Earl Sweatshirt	Some Rap Songs	spotify:track:2KrHM3YwVwewEAxss7iuj7

Reborn	KIDS SEE GHOSTS	KIDS SEE GHOSTS	spotify:track:4RVbK6cV0VqWdpCDcx3hiT

Wide Awake	Parquet Courts	Wide Awake!	spotify:track:7COxY38TB5HTeXRAucOEW4



winter 18

1539 N. Calvert	JPEGMAFIA	Veteran	spotify:track:6XyxCBp6x3jvtxXvMN5sAA

Hold On, We're Going Home	Drake, Majid Jordan	Nothing Was The Same (Deluxe)	spotify:track:6jdOi5U5LBzQrc4c1VT983

Vetements Socks	Sheck Wes	MUDBOY	spotify:track:05qIDU9cr1qoJIz46wveLe

Drip From My Walk	Famous Dex	Drip From My Walk	spotify:track:1eQIZQTJ3CQOYJPY7EOUKp

BLACK BALLOONS | 13LACK 13ALLOONZ [FEAT. TWELVE'LEN & GOLDLINK | TWELVE'LEN + GOLDL1NK]	Denzel Curry, Twelve'len, GoldLink	TA13OO	spotify:track:5mexbTuWx9d8DPZk4sDGF4

SWITCH IT UP | ZWITCH 1T UP	Denzel Curry	TA13OO	spotify:track:7oopoWQa0jicMSf9SFtxMK

One Minute (feat. Kanye West & Travis Barker)	XXXTENTACION, Kanye West, Travis Barker	SKINS	spotify:track:0T6RSXxFhW8dRTWHI604ld

Faucet Failure	Ski Mask The Slump God	STOKELEY	spotify:track:1ThmUihH9dF8EV08ku5AXN

KANGA	6ix9ine, Kanye West	DUMMY BOY	spotify:track:0EwS8XJQspgrj1zSUXhFkl

Wide Awake	Parquet Courts	Wide Awake!	spotify:track:7COxY38TB5HTeXRAucOEW4

The Mint (feat. Navy Blue)	Earl Sweatshirt, Navy Blue	Some Rap Songs	spotify:track:5uLZ3YIQGC0mOk6q3lJ6Ng

thank u, next	Ariana Grande	thank u, next	spotify:track:3e9HZxeyfWwjeyPAMmWSSQ



michaelmas 18

Choppa Won't Miss (feat. Young Thug)	Playboi Carti, Young Thug	Die Lit	spotify:track:5O9zs6G6RcB6yP1OKwnwiM

Lean 4 Real (feat. Skepta)	Playboi Carti, Skepta	Die Lit	spotify:track:1JgkiUg9mSXSwcb5Gbi4Ur

Drip Too Hard	Lil Baby, Gunna	Drip Too Hard	spotify:track:1BxkZE73h9BN3qwuA15TA3

Drowning (feat. Kodak Black)	A Boogie Wit da Hoodie, Kodak Black	The Bigger Artist	spotify:track:1f5cbQtDrykjarZVrShaDI

Wake Up in the Sky	Gucci Mane, Bruno Mars, Kodak Black	Wake Up in the Sky	spotify:track:0QIjsbm2fh1cJ45XO9eGqq

VENGEANCE | VENGEANCE [FEAT. JPEGMAFIA & ZILLAKAMI | JPEGMAF1A + Z1LLAKAM1]	Denzel Curry, JPEGMAFIA, ZillaKami	TA13OO	spotify:track:4d8BSdhx6WT5GtTOWpv4rh

Topanga	Trippie Redd	Topanga	spotify:track:3tcnWNjEXyXCbFR9zonrX2

STARGAZING	Travis Scott	ASTROWORLD	spotify:track:7wBJfHzpfI3032CSD7CE2m

CAN'T GET OVER YOU (feat. Clams Casino)	Joji, Clams Casino	CAN'T GET OVER YOU (feat. Clams Casino)	spotify:track:7ewESHEg3P3JN66IcWwDho

Soberland	Hinds	I Don't Run	spotify:track:3oIofvdZAQnGsPaWUf1jki

Bamboo	Hinds	Very Best Of Hinds So Far	spotify:track:37v3LZcy3S2Z77oG5COufs

Montego Bae	Noname, Ravyn Lenae	Room 25	spotify:track:1g2mY3SYKNI90COS9x8dgB

The Weekend	SZA	Ctrl	spotify:track:6gU9OKjOE7ghfEd55oRO57

Homie (feat. Meek Mill)	Young Thug, Carnage, Young Stoner Life Records, Meek Mill	Homie (feat. Meek Mill)	spotify:track:2jtyXJWIe9YFqqt6ZOeqw6



summer 18

All Of A Sudden	Lil Baby, Moneybagg Yo	Too Hard	spotify:track:0XOMoQbYxYPVLxwK4VDmNA

Freeee (Ghost Town Pt. 2)	KIDS SEE GHOSTS, Ty Dolla $ign	KIDS SEE GHOSTS	spotify:track:7GRTrWsP3yo2Fx8umJfA1X

Rubbin off the Paint	YBN Nahmir	Rubbin Off The Paint	spotify:track:1QRJb5VY3sIkCKcTuIKCrk

Psycho (feat. Ty Dolla $ign)	Post Malone, Ty Dolla $ign	beerbongs & bentleys	spotify:track:3swc6WTsr7rl9DqQKQA55C

Come Back Baby	Pusha T	DAYTONA	spotify:track:2BuBXn15gj4MNYZydyWgrk

Self Care	Mac Miller	Swimming	spotify:track:5bJ1DrEM4hNCafcDd1oxHx

Nonstop	Drake	Scorpion	spotify:track:0TlLq3lA83rQOYtrqBqSct

SICKO MODE	Travis Scott	ASTROWORLD	spotify:track:2xLMifQCjDGFmkHkpNLD9h

Nephew (feat. Lil Pump)	Smokepurpp, Lil Pump	Nephew (feat. Lil Pump)	spotify:track:0ibOcbkp2XG46Do8jcy0bL

In My Feelings	Drake	Scorpion	spotify:track:2G7V7zsVDxg1yRsu7Ew9RJ

Ghost Town	Kanye West, PARTYNEXTDOOR	ye	spotify:track:6Bg7MznA9X0dIhlAsLyBYj

I Should Live in Salt	The National	Trouble Will Find Me	spotify:track:6gf7WF9nXNON9HdNtrdEDq

SAD!	XXXTENTACION	?	spotify:track:3ee8Jmje8o58CHK66QrVC2

Nice For What	Drake	Scorpion	spotify:track:3CA9pLiwRIGtUBiMjbZmRw



trinity 18

Mr Noah	Panda Bear	Panda Bear Meets The Grim Reaper	spotify:track:7ckdEBWRPr2Cisjg2PLyr1

Boys Latin	Panda Bear	Panda Bear Meets The Grim Reaper	spotify:track:178yi3jvbIHwnaxeAVUCD9

All My Friends	LCD Soundsystem	Sound Of Silver	spotify:track:2Ud3deeqLAG988pfW0Kwcl

Y Control	Yeah Yeah Yeahs	Fever To Tell	spotify:track:69zg9x0yFIa4TRzRsroCav

Sacrilege	Yeah Yeah Yeahs	Sacrilege	spotify:track:7KnECW538nd1RUbMCduQsM

ur phone	boy pablo	Roy Pablo	spotify:track:1sdW5wGFuUB0A93EN7BhaL

Ah Ndiya	Oumou Sangar√©	Moussolou	spotify:track:0Eyt6ZkFhMdLUSwY3v5oHD

Fadjamou	Oumou Sangar√©	Mogoya	spotify:track:2CcYI8KxDgOiOaM7axIP3h

Kamelemba	Oumou Sangar√©	Mogoya	spotify:track:2T7FMI7aQ3zcnDH1YzRj0x

Them Changes	Thundercat	Drunk	spotify:track:7CH99b2i1TXS5P8UUyWtnM

Homemade Dynamite	Lorde	Melodrama	spotify:track:1cCvYJfIMonvkTsKAD6oME

Supercut	Lorde	Melodrama	spotify:track:6TgBrRvbC64WMetf2hXrUS

Team	Lorde	Pure Heroine	spotify:track:5KcYtdjhsQrNNMjJOSAUEz

Ribs	Lorde	Pure Heroine	spotify:track:2qwaiTzRiDdpAEBfVQeiYN

I Dare You	The xx	I See You	spotify:track:044qU7kwVZaDwzWnRsmVVL

Praise The Lord (Da Shine) (feat. Skepta)	A$AP Rocky, Skepta	TESTING	spotify:track:7ycWLEP1GsNjVvcjawXz3z

CHILD‚ÄôS PLAY	Ski Mask The Slump God	BEWARE THE BOOK OF ELI	spotify:track:4phXcw8nS9ZjrNeiXbhSNO

Blister in the Sun - 2002 Remastered Version	Violent Femmes	Violent Femmes	spotify:track:5TM2eqdzfWPHklI7YnBmsD

Heart and Soul	Joy Division	The Best Of	spotify:track:4fokGJSBrxFIvt01vz1Fbe

Wish (feat. Trippie Redd)	Diplo, Trippie Redd	Wish (feat. Trippie Redd)	spotify:track:0HriJqzc3lu73JzL2pS1sD

If You Know You Know	Pusha T	DAYTONA	spotify:track:6bGwKHXHNLmTy6yt147FPh



easter 18

Hellboy	Trippie Redd	A Love Letter To You 2	spotify:track:11tc8tYZjqmoe3ObKlgsmL

Designer	Lil Pump	Designer	spotify:track:1LXbv9jiTtdBdHadZ317Gt

Passionfruit	Drake	More Life	spotify:track:7hDc8b7IXETo14hHIHdnhd

Green Light	Lorde	Melodrama	spotify:track:0gbBzIqrECJOEPvQJIBFs5

Goldie	A$AP Rocky	LONG.LIVE.A$AP (Deluxe Version)	spotify:track:4go2hxLM6ijk0K76ZY0Nhd

Finesse - Remix; feat. Cardi B	Bruno Mars, Cardi B	Finesse (Remix) [feat. Cardi B]	spotify:track:3Vo4wInECJQuz9BIBMOu8i

infinity (888) - feat. Joey Bada$$	XXXTENTACION, Joey Bada$$	?	spotify:track:7J2gyNghNTzl4EsLhXp01Q

raingurl	Yaeji	raingurl	spotify:track:4gRAniZdYF2zVrDUsNC9tU

Be Careful	Cardi B	Invasion of Privacy	spotify:track:2Yl4OmDby9iitgNWZPwxkd

I Do (feat. SZA)	Cardi B, SZA	Invasion of Privacy	spotify:track:1f5PNhkNgUpvDEeZfcIlO1

Look Alive (feat. Drake)	BlocBoy JB, Drake	Look Alive (feat. Drake)	spotify:track:4qKcDkK6siZ7Jp1Jb4m0aL



hilary 18

King's Dead (with Kendrick Lamar, Future & James Blake)	Jay Rock, Kendrick Lamar, Future, James Blake	King's Dead (with Kendrick Lamar, Future & James Blake)	spotify:track:08qFPu7ksp9KrQJJPuFXxu

Only God Knows	Young Fathers, Leith Congregational Choir	Only God Knows	spotify:track:7vmLW0qZn0vBgH6WN7ZAnC

Don't Don't Do It!	N.E.R.D, Kendrick Lamar, Pharrell Williams	NO ONE EVER REALLY DIES	spotify:track:2svutFGaCycRmYc1mWbfQh

BOOGIE	BROCKHAMPTON	SATURATION III	spotify:track:3NuN59jpH3B5cNa2M4r7XG

MotorSport	Migos, Nicki Minaj, Cardi B	MotorSport	spotify:track:22Je85Q7fw8oVDRIHiv4z3

Danger (with Migos & Marshmello)	Migos, Marshmello	Danger (with Migos & Marshmello) [From Bright: The Album]	spotify:track:0nhVrTiCGiGRCoZOJiWzm1

Ice Tray	Quality Control, Quavo, Lil Yachty	Quality Control: Control The Streets Volume 1	spotify:track:5XqhLDOcpTeZpAzHUHYGuA

Gucci Gang	Lil Pump	Lil Pump	spotify:track:43ZyHQITOjhciSUUNPVRHc

Learn How to Watch (feat. Mac Miller & MadeinTYO)	Carnage, Mac Miller, MadeinTYO	Learn How to Watch (feat. Mac Miller & MadeinTYO)	spotify:track:310Qd5lOzFStXKZB3zWCtE

List Of People (To Try And Forget About)	Tame Impala	Currents B-Sides & Remixes	spotify:track:2IbP1N3WKj8nPwbLf14xlm

New For You	Hinds	New For You	spotify:track:5uWjmOApTjHwbGdkOVUHyJ

All The Stars (with SZA)	Kendrick Lamar, SZA	All The Stars (with SZA)	spotify:track:12SJpYZEdj4kzWZ8FPFg4Y

After The Storm (feat. Tyler, The Creator & Bootsy Collins)	Kali Uchis, Tyler, The Creator, Bootsy Collins	After The Storm (feat. Tyler, The Creator & Bootsy Collins)	spotify:track:0Vmn11PNm5bcLzdJVGfuBH

Fuck Love (feat. Trippie Redd)	XXXTENTACION, Trippie Redd	17	spotify:track:7AQim7LbvFVZJE3O8TYgf2



summer 17

Another Weekend	Ariel Pink	Another Weekend	spotify:track:2zBldnZI3K7EzWWv53gUSv

911 / Mr. Lonely (feat. Frank Ocean & Steve Lacy)	Tyler, The Creator, Frank Ocean, Steve Lacy	Flower Boy	spotify:track:4bEcoz1OcfMgUbp2ft8ieQ

goosebumps	Travis Scott	Birds In The Trap Sing McKnight	spotify:track:6gBFPUFcJLzWGx4lenP6h2

Slippery (feat. Gucci Mane)	Migos, Gucci Mane	Culture	spotify:track:6p8NuHm8uCGnn2Dtbtf7zE

Someday	The Strokes	Is This It	spotify:track:5PMNuabTV5BaTahIawahcp

Boredom (feat. Rex Orange County & Anna of the North)	Tyler, The Creator, Rex Orange County, Anna of the North	Flower Boy	spotify:track:5WNYg3usc6H8N3MBEp4zVk

Is This It	The Strokes	Is This It	spotify:track:5DeV5m5gzNq0KvlaZs3Eb6

Ivy	Frank Ocean	Blonde	spotify:track:2ZWlPOoWh0626oTaHrnl2a

711	Higher Brothers	Black Cab	spotify:track:49gWRs13smbgMgIaDvprp2

RAF	A$AP Mob, A$AP Rocky, Playboi Carti, Quavo, Lil Uzi Vert, Frank Ocean	RAF	spotify:track:6kl1qtQXQsFiIWRBK24Cfp

GOLD	BROCKHAMPTON	SATURATION	spotify:track:7HRv1sYuwgoea1m0JRvChV

Peek A Boo	Lil Yachty, Migos	Teenage Emotions	spotify:track:01VvADRZqvXrHfwAKUOS8v

Neptune Estate	King Krule	6 Feet Beneath the Moon	spotify:track:0V1QOLJFWimtf6eJvSYEHO

Man of War	Radiohead	OK Computer OKNOTOK 1997 2017	spotify:track:552BIJ9kKwwqiGf4YojYbL

Dance, Dance, Dance	Lykke Li	Youth Novels	spotify:track:68s9Rkn9dyuonMXZXkKvWo

pick up the phone	Young Thug, Travis Scott	Birds In The Trap Sing McKnight	spotify:track:20dP2DaMHIAmwWAbp7peSr

Kanye West	Young Thug, Wyclef Jean	JEFFERY	spotify:track:5StUs128KSibE16fxntBSL

Believe	A-Trak, Quavo, Lil Yachty	Believe	spotify:track:5fMpeV5TN9BRpeHIlE8VhD

Plimsoll Punks	Alvvays	Antisocialites	spotify:track:6XmOUsOiaIXZ16izZtkW5m

Biking	Frank Ocean, JAY-Z, Tyler, The Creator	Biking	spotify:track:2q0VexHJirnUPnEOhr2DxK



trinity 17

STAR	BROCKHAMPTON	SATURATION	spotify:track:1xfFPJdRjgDAaMcDgbXwyh

Without You	Wes Montgomery	California Dreaming	spotify:track:1K2mF6AOIpU5HyHI59d9Tz

HEAT	BROCKHAMPTON	SATURATION	spotify:track:2maEFaoAyNjQVv14Hm4esN

Bamboo	Homeboy Sandman	Veins	spotify:track:1qVrXQtJAF05jozjfd5Yft

PRIDE.	Kendrick Lamar	DAMN.	spotify:track:5AL46kwqlBX7qWP3qUppJe

XXX. FEAT. U2.	Kendrick Lamar, U2	DAMN.	spotify:track:73HCBO1XCKxNMTZLTFgs8A

Out Getting Ribs	King Krule	6 Feet Beneath the Moon	spotify:track:1QiWCtj9IT0fKjxBqHXhWL

Hey Kids (Bumaye) [feat. Danny Brown]	Run The Jewels, Danny Brown	Run the Jewels 3	spotify:track:4gPSBIQakeh8CsNze49txT

Talk to Me	Run The Jewels	Run the Jewels 3	spotify:track:3AT07E7tLLthDh3Bb5yT7A

ELEMENT.	Kendrick Lamar	DAMN.	spotify:track:6rZssCJPEdQnyeEdNLKsr8

Mask Off - Remix	Future, Kendrick Lamar	Mask Off (Remix)	spotify:track:6DB2KOEwHnjkgEnBt5SdeJ

Telephone Calls	A$AP Mob, A$AP Rocky, Tyler, The Creator, Playboi Carti, Yung Gleesh	Cozy Tapes: Vol. 1 Friends -	spotify:track:5VnpYqIzm02X9gOhVElQo3

YAH.	Kendrick Lamar	DAMN.	spotify:track:22uyC54d6XAPRTlc6IchaP

I Promise	Radiohead	OK Computer OKNOTOK 1997 2017	spotify:track:6V9PDDZ2pHQCUleRXvRYQ1

Evening Prayer	Jens Lekman, LouLou Lamotte	Life Will See You Now	spotify:track:1HjD0L3YE2MFnyaNlsf055

FEAR.	Kendrick Lamar	DAMN.	spotify:track:3SP0MlWYfu7xt1ZfMqBxh9



spring 17

Unforgiving Girl (She's Not An)	Car Seat Headrest	Teens of Denial	spotify:track:4cwFsqfbKjAhHxV8By0NBV

Easy Easy	King Krule	6 Feet Beneath the Moon	spotify:track:08ZsI74y3P6mQw8En1c6tQ

Snap Out Of It	Arctic Monkeys	AM	spotify:track:0NdTUS4UiNYCNn5FgVqKQY

These Days	Nico	Chelsea Girl	spotify:track:2ZRBKVRMQ9OK4EeTaMHHSY

Always Sad	The Jesus and Mary Chain	Damage and Joy	spotify:track:25QNHGr0GvHyaXShZYRJnN

The Noose of Jah City	King Krule	King Krule	spotify:track:0wcImcUemunoyKSXn6qqFj

No Buses	Arctic Monkeys	Who The F*** Are Arctic Monkeys?	spotify:track:6mOiT65GFmXgBAviM3lrsE

The Heart Part 4	Kendrick Lamar	The Heart Part 4	spotify:track:1zayuwd1YLZsYDArkruHdL

A Lizard State	King Krule	6 Feet Beneath the Moon	spotify:track:0KzFcd3gLfmsVEOqpOogBt



winter 17

New York	St. Vincent	MASSEDUCTION	spotify:track:5Lc26cde6qDfabliO2Nu4A

Redbone	Childish Gambino	"Awaken, My Love!"	spotify:track:2Uvy6SkNqxvnH1W68dymxG

I Am Trying to Break Your Heart	Wilco	Yankee Hotel Foxtrot	spotify:track:3HWxpLKnTlz6jE3Vi5dTF2

7/11	Beyonc√©	BEYONC√â [Platinum Edition]	spotify:track:02M6vucOvmRfMxTXDUwRXu

Flo Rida	Higher Brothers, Ski Mask The Slump God	Flo Rida	spotify:track:0R01L2PrvabbllwxJYZyfd

Take on Me	a-ha	Hunting High and Low	spotify:track:2WfaOiMkCvy7F5fcp2zZ8L

Townie	Mitski	Bury Me At Makeout Creek	spotify:track:2HUIm4ZmwC5aIEQQakmgO4

Hey Ya! - Radio Mix / Club Mix	OutKast	Speakerboxxx/The Love Below	spotify:track:5WQ1hIc5d2EVbRQ8qsj8Uh

rockstar	Post Malone, 21 Savage	rockstar	spotify:track:7wGoVu4Dady5GV0Sv4UIsx

Chinese Slippers	Princess Nokia	1992 Deluxe	spotify:track:4dpCL4YzgPPJNV57GLipMx

Bart Simpson	Princess Nokia	1992 Deluxe	spotify:track:1mTymOohmNmDtuxDIGAEgK

Ric Flair Drip (& Metro Boomin)	Offset, Metro Boomin	Without Warning	spotify:track:7sO5G9EABYOXQKNPNiE9NR

BUTTERFLY EFFECT	Travis Scott	BUTTERFLY EFFECT	spotify:track:1yxgsra98r3qAtxqiGZPiX



michaelmas 17

Power	Rapsody, Kendrick Lamar, Lance Skiiiwalker	Laila‚Äôs Wisdom	spotify:track:6SxfpFpECdR0bc0aL8Rygq

Dum Surfer	King Krule	Dum Surfer	spotify:track:7pB87aZPsItkLtgLUVgcaZ

See You Sweat	Injury Reserve	Drive It Like It's Stolen	spotify:track:3o632iBnSZ4LFDCacGkP3X

Catch Me Outside	Ski Mask The Slump God	Catch Me Outside	spotify:track:7ojVOpAO0rFvAjCDYScCWJ

Flo Rida	Higher Brothers, Ski Mask The Slump God	Flo Rida	spotify:track:0R01L2PrvabbllwxJYZyfd

Lemon	N.E.R.D, Rihanna	Lemon	spotify:track:6tUgfsOa8PLkoede5nOR7D

Everytime	boy pablo	Roy Pablo	spotify:track:4zvHZWOGyL7WcmqHOgtGCW

ur phone	boy pablo	Roy Pablo	spotify:track:1sdW5wGFuUB0A93EN7BhaL

Bank Account	21 Savage	Issa Album	spotify:track:2fQrGHiQOvpL9UgPvtYy6G

Congratulations	Post Malone, Quavo	Stoney	spotify:track:6syOdAs4IK8kPWR7gDyjRw

Achoo	Ski Mask The Slump God, Keith Ape	Achoo	spotify:track:7sYyFKYrEjB34gOkggk0vh



hilary 17

Broccoli (feat. Lil Yachty)	DRAM, Lil Yachty	Big Baby DRAM	spotify:track:7yyRTcZmCiyzzJlNzGC9Ol

GLOWED UP	KAYTRANADA, Anderson .Paak	99.9%	spotify:track:33pDmPx2pkJ7JCAQpRDQ9B

Drunk Drivers/Killer Whales	Car Seat Headrest	Teens of Denial	spotify:track:2os0aK782bakCPmjow0SU0

One Night	Lil Yachty	Lil Boat	spotify:track:36UuD5tbu7TyugjJLMTzCr

Call Ticketron	Run The Jewels	Run the Jewels 3	spotify:track:6M3RWxZ2aRapomSbsy5Zvl

VRY BLK (feat. Noname)	Jamila Woods, Noname	HEAVN	spotify:track:7mZwDdRKbjdepbXS0gLZFs

Minnesota	Lil Yachty, Quavo, Skippa Da Flippa, Young Thug	Lil Boat	spotify:track:2BuiPl9kQIqW4Uuce65MZq

Dat $tick	Rich Brian	Dat $tick	spotify:track:4bdJHQp90ymjEIkkYhcENB

Cash Machine	DRAM	Big Baby DRAM	spotify:track:6GG2tkV9PRYGN5rniXPFXZ

Who That Be	Rich Brian	Who That Be	spotify:track:1XSvndyw6uqVW1ekRZsJUp

Only God Knows	Young Fathers, Leith Congregational Choir	Only God Knows	spotify:track:7vmLW0qZn0vBgH6WN7ZAnC



winter 16

Fill in the Blank	Car Seat Headrest	Teens of Denial	spotify:track:1EALzILzmIPtRIvYyo6Lwm

Really Doe	Danny Brown, Kendrick Lamar, Ab-Soul, Earl Sweatshirt	Atrocity Exhibition	spotify:track:6dHatCnuOb1TdBIeJTK3Y0

Ain't it Funny	Danny Brown	Atrocity Exhibition	spotify:track:7ItFoQDmQIh3MAPsxiP6Vt

This Charming Man - 2011 Remaster	The Smiths	The Smiths	spotify:track:1FvDJ9KGxcqwv1utyPL3JZ

Legend Has It	Run The Jewels	Run the Jewels 3	spotify:track:6bGwloiyyHXwFZ4yV1zjqR

Ultralight Beam	Kanye West	The Life Of Pablo	spotify:track:0Wi7iEDGFY7I7NkYU6gS4n

Casimir Pulaski Day	Sufjan Stevens	Illinois	spotify:track:1u1YU1LE0FWHFOHpR2iXua

The Man of Metropolis Steals Our Hearts	Sufjan Stevens	Illinois	spotify:track:38we3lrq4NEsMQ8PaJeer4

King Kunta	Kendrick Lamar	To Pimp A Butterfly	spotify:track:1vffte5WTHIik37ePfJdo4

On Melancholy Hill	Gorillaz	Plastic Beach	spotify:track:0q6LuUqGLUiCPP1cbdwFs3



michaelmas 16

No Problem (feat. Lil Wayne & 2 Chainz)	Chance the Rapper, Lil Wayne, 2 Chainz	Coloring Book	spotify:track:0v9Wz8o0BT8DU38R4ddjeH

THat Part - Black Hippy Remix	ScHoolboy Q	THat Part (Black Hippy Remix)	spotify:track:5hcgfIepwGYXO5AVX1vI0v

Shut Up Kiss Me	Angel Olsen	MY WOMAN	spotify:track:5uZLsGY9fknBd5Rxr7AIss

Groovy Tony	ScHoolboy Q	Groovy Tony	spotify:track:1iqjADC1pLl3vgeO8CN9dn

No More Parties In LA	Kanye West	The Life Of Pablo	spotify:track:4DID8YTzKYIWW3TL6kRVUe

The Battle of Hampton Roads	Titus Andronicus	The Monitor	spotify:track:5NMAqcz6QYf95u3R8Xm2kX

The Lord's Favorite	Iceage	Plowing Into the Field of Love	spotify:track:4I2LbmU2yiY2p6m5gJRcRy



Long Vacation 16

Let It Happen	Tame Impala	Currents	spotify:track:068LmtzI6xJJDPfPnMje0U

untitled 05 09.21.2014.	Kendrick Lamar	untitled unmastered.	spotify:track:5N1BkOJ1CTHbSC1RZ6LFJu

Seasons (Waiting On You) [BADBADNOTGOOD Reinterpretation]	Future Islands	Seasons (Waiting On You) [BADBADNOTGOOD Reinterpretation]	spotify:track:5ZwPh4nNgNChn3b5ZAXhzA

Angeles	Doom, Ghostface	Unexpected Guests	spotify:track:289KyCtt2Xj4RIJRTFpFQJ

FloriDada	Animal Collective	Painting With	spotify:track:26WNKAgxNfg1MkhpBrx8UV

Sloopy Lau Lau	Mac DeMarco	Salad Days Demos	spotify:track:6sRSsfRK3P94riWBjlYuvp

From Trouble They Know Me	Trouble Knows Me	Trouble Knows Me	spotify:track:0lgmBKxmBYmsi2OyGnG9E4

Hi-Five	Angel Olsen	Burn Your Fire for No Witness	spotify:track:42fEnOefqFWJ3RBfQUQWzg

Work Work	clipping., Cocc Pistol Cree	CLPPNG	spotify:track:3xnAzzr9gNrLTXNUjqPMpm

Dang! (feat. Anderson .Paak)	Mac Miller, Anderson .Paak	The Divine Feminine	spotify:track:5iUQMwxUPdJBFeGkePtM66

Wondering	Xiu Xiu	FORGET	spotify:track:0163YUM6BGkHfbRQHQ7BxD

Forgiven / Forgotten	Angel Olsen	Burn Your Fire for No Witness	spotify:track:3sO9MnNDvbdTGNOomTo6hY

Handshakes with Snakes	Apathy, Maria Grazia, B Real, Sick Jacken	Handshakes with Snakes	spotify:track:30d7AiU5aApbxKGY52tyDU

The Less I Know The Better	Tame Impala	Currents	spotify:track:4g3Ax56IslQkI6XVfYKVc5



NS 14/15

free press and curl	Shabazz Palaces	Black Up	spotify:track:6lJZyQ5tvKk8BtSHmOs4IC

The Moon Song - Film Version	Scarlett Johansson, Joaquin Phoenix	The Moon Song (Music From And Inspired By The Motion Picture Her) - Single	spotify:track:32B4X4PQxAQTrMs5S1OVsB

Salad Days	Mac DeMarco	Salad Days	spotify:track:4keAoywVf4jxRvXU7ON0hV

Human Sadness	The Voidz	Tyranny	spotify:track:2avCzL6HtaJ5Nspq2fVFQe

Swerve... the reeping of all that is worthwhile (Noir not withstanding)	Shabazz Palaces	Black Up	spotify:track:5kC3aAeAh0RNAn7D6JMU94

100 Grandkids	Mac Miller	GO:OD AM	spotify:track:4z0PnuB07fxtVZZRWsCfxb

Everything Is Embarrassing	Sky Ferreira	Night Time, My Time	spotify:track:7j3nbSiaWphYU2cFgyQXd9

Recover	CHVRCHES	The Bones Of What You Believe (Special Edition)	spotify:track:05NIbGxolEHpEP7540Vs3J

How Could You Babe	Tobias Jesso Jr.	Goon	spotify:track:3UTD8DQ1liGCFd9lE0gQDR

Sunday Candy	Donnie Trumpet & The Social Experiment	Surf	spotify:track:6fTdcGsjxlAD9PSkoPaLMX

Seasons (Waiting On You)	Future Islands	Singles	spotify:track:41X9To0bQ4fpoSRri4NHiI

10,000 Emerald Pools	B√òRNS	Dopamine	spotify:track:3W6TDna43DO3l8xOOLFd6b

An echo from the hosts that profess infinitum	Shabazz Palaces	Black Up	spotify:track:4gkxGrIuTzLykIq0aG5xUe

Oblivion	Grimes	Visions	spotify:track:2RtNSM8cPCAOZ5bvQbW6y3

Biutiful	Ash Koosha	I AKA I	spotify:track:7jrOiY7kgZEygUnSpKWQse

Victory Laps	DOOMSTARKS	Victory Laps	spotify:track:0sQ9MCD0ichtBCSi8Khn3h

Time Moves Slow	BADBADNOTGOOD, Samuel T. Herring	IV	spotify:track:7p7Epk1oBEgUIbpqqDyIQB



healthcore

#20	Aphex Twin	Selected Ambient Works Volume II	spotify:track:5IExVHUiRccCWyJ4imu9qD

#3	Aphex Twin	Selected Ambient Works Volume II	spotify:track:2Bc4llhjJBW77I552RgA3L

Treefingers	Radiohead	Kid A	spotify:track:4DPQvbgSM0IdX4O3HOACwL

An Ending (Ascent) - Remastered 2005	Brian Eno	Apollo	spotify:track:1vgSaC0BPlL6LEm4Xsx59J

Olson	Boards of Canada	Music Has The Right To Children	spotify:track:0aPrTlWUf2nmDkC9gcP5kZ

One More Love Song - Instrumental	Mac DeMarco	Old Dog Demos	spotify:track:2NxitmAxlurYtivHLiNsAw

Another (Demo) One #1	Mac DeMarco	Another (Demo) One	spotify:track:39LlCU3uaxUreXiReHZD0g

Sloopy Lau Lau	Mac DeMarco	Salad Days Demos	spotify:track:6sRSsfRK3P94riWBjlYuvp

Space Cadet - Instrumental	Metro Boomin	NOT ALL HEROES WEAR CAPES (Deluxe)	spotify:track:1NeZpPnNi3DblecF4HIA9h

10 Freaky Girls - Instrumental	Metro Boomin	NOT ALL HEROES WEAR CAPES (Deluxe)	spotify:track:4TGw3fSZwRDlowy9JjiH6r

Supersymmetry	Arcade Fire	Reflektor (Deluxe)	spotify:track:35rLWHaFssX34SF2Y4923F



upsetting music

Klavierstuck V, Work No. 4	Karlheinz Stockhausen, Fredrik Ullen	Stockhausen: Zyklus - Klavierstucke V and IX - Kontakte	spotify:track:5XTt9kMdiUEF3rwsl2jbCd

12 Notations pour piano: II Tr√®s vif	Pierre Boulez, David Fray	Bach: Partita in D major, French Suite in D minor/Boulez: Douze Notations pour piano, Incises	spotify:track:5iqyYVGaRNhQdUzTH3nAxn

12 Notations pour piano: V Doux et improvis√©	Pierre Boulez, David Fray	Bach: Partita in D major, French Suite in D minor/Boulez: Douze Notations pour piano, Incises	spotify:track:3juZzlfSwlITJRfmnGGbBA

12 Notations pour piano: XI Scintillant	Pierre Boulez, David Fray	Bach: Partita in D major, French Suite in D minor/Boulez: Douze Notations pour piano, Incises	spotify:track:3xZiaLaqTq5jIjEyISHbcl

Boulez: 12 Notations for Piano: X. M√©canique et tr√®s sec	Pierre Boulez, David Fray	Bach: Partita in D major, French Suite in D minor/Boulez: Douze Notations pour piano, Incises	spotify:track:7cy0myvAluIzUVLEomjLu7



chilla

Beach House	boy pablo	Beach House	spotify:track:4Ura5SWeFhd9VccTDKkcLM

Out Getting Ribs	King Krule	6 Feet Beneath the Moon	spotify:track:1QiWCtj9IT0fKjxBqHXhWL

Neptune Estate	King Krule	6 Feet Beneath the Moon	spotify:track:0V1QOLJFWimtf6eJvSYEHO

Space Song	Beach House	Depression Cherry	spotify:track:1ujxjsoNvh4XgS2fUNwkZ2

Used to Be	Beach House	Teen Dream	spotify:track:1WxBdKoBP6fywxzoZNwJXs

I Think Ur A Contra	Vampire Weekend	Contra	spotify:track:3BLxSMHBC4DcMsTGFwjUH0

Alter Ego	Tame Impala	InnerSpeaker	spotify:track:0XfRZ6lABIms6gDOsDki2p

Why Won't You Make Up Your Mind?	Tame Impala	InnerSpeaker	spotify:track:03UtSH0PLNzr9qMTzqttCc

Keep On Lying	Tame Impala	Lonerism	spotify:track:2eECiyEWKrdD0m0qbU5Wpw

feelings change	Yaeji	EP2	spotify:track:625nTE7Ex8UJgx5RMjnRik

About Face	Grizzly Bear	Veckatimest	spotify:track:66zSeZQdUUI6BKA1yDmqc9

Everytime	boy pablo	Roy Pablo	spotify:track:4zvHZWOGyL7WcmqHOgtGCW

Ode to Viceroy	Mac DeMarco	2	spotify:track:601KiLiZtBJRTXBrTjeieP

One Another	Mac DeMarco	This Old Dog	spotify:track:4xF9zRaPdnrLU7QmVMKOzR

Unfucktheworld	Angel Olsen	Burn Your Fire for No Witness	spotify:track:0mTW7wRLKdLmFgNfbhAQ8g

The End of the World	Sharon Van Etten	The End of the World	spotify:track:0Sg9bWEaPtDO2JE7qwcMvy

Sea Calls Me Home	Julia Holter	Have You In My Wilderness	spotify:track:2vUMdAub2h5j5zuSppYQyT

Wakin on a Pretty Day	Kurt Vile	Wakin On A Pretty Daze	spotify:track:3cSlU4ZH4wzb5pM7wI1k3f

Pieces Of The People We Love	The Rapture	Pieces Of The People We Love (Non EU Version)	spotify:track:6bmxyXEYTbApvFnlIucFId

In Your Own Sweet Way	Wes Montgomery	Incredible Jazz Guitar	spotify:track:392OK8Qdmos0wNDrduiwy0

Every Single Thing	HOMESHAKE	Fresh Air	spotify:track:7yZTPEXSUqWw7sEYKKDv2N

Sloopy Lau Lau	Mac DeMarco	Salad Days Demos	spotify:track:6sRSsfRK3P94riWBjlYuvp



sway

These Walls	Kendrick Lamar, Bilal, Anna Wise, Thundercat	These Walls	spotify:track:7BMfDsoZkEPmamlkvptvJl

Horse Steppin‚Äô	Sun Araw	Beach Head	spotify:track:2rYZETHlA6JTDbbkAWj9jD

YOU'RE THE ONE	KAYTRANADA, Syd	99.9%	spotify:track:2b4SSorCTQ2VzmllaeWuuT

Feel It Out	Yaeji	yaeji	spotify:track:5nmELUHxIpgZYTOsPPufbQ

So Polite	Summer Salt	So Polite	spotify:track:15z8ZeMZXrUrkO5ydZnSmo

Let It Happen - Soulwax Remix	Tame Impala, Soulwax	Currents B-Sides & Remixes	spotify:track:0Sxr5DOtd39MVojwC1motg

Nice Boys	TEMPOREX	Care	spotify:track:5H2WmzaijYOGTHeHdM3w9P



jizz jazz

Eronel	Thelonious Monk	Criss-Cross (Expanded Edition)	spotify:track:67tnJf77mVKMIOVcR1SQ2F

Summer Samba (So Nice)	Walter Wanderley	Rain Forest (Reissue)	spotify:track:6KhBbxrxjj3Mdgw8h6XSeD

I Love Paris	Cal Tjader	Latin Kick	spotify:track:49HPPuvqvsxLLHB3y09eBw

Con Alma	Dizzy Gillespie	Afro	spotify:track:5KNIhdBt7K8pM98mOfPt4e

The Girl From Ipanema	Walter Wanderley	Rain Forest (Reissue)	spotify:track:0l2n5Zglde7qnLzj1h15k3

September Song	Cal Tjader	Latin Kick	spotify:track:6JgK4IFLBjYfEatQHWautL

Airegin	Wes Montgomery	Incredible Jazz Guitar	spotify:track:2UCUSLYC6EX0AGnI7DAC35

Rain	Walter Wanderley	Rain Forest (Reissue)	spotify:track:69hnVtvLM7xIU5IGGmUMX7

Curacao	Cal Tjader	Soul Burst	spotify:track:3VXYM1cAAavBcs9ZdKigYf

Brilliant Corners	Thelonious Monk, Sonny Rollins, Ernie Henry	Jazz Six Pack	spotify:track:2udOc0pxxsIGCVIgXne0gU

Spooky - Live from The Lighthouse, February 1969	Cal Tjader	Plugs In	spotify:track:2eUJvR04afB1G6YxhiCYZe

Tin Tin Deo	Dizzy Gillespie	Odyssey 1945-1952	spotify:track:3Es6jOB49feBM89rS3ppJw

Blue Camel	Rabih Abou-Khalil	Blue Camel	spotify:track:41RZExlqDu907Cq7Zci3pA

Beach Samba	Walter Wanderley	Rain Forest (Reissue)	spotify:track:6SKghwlaALmPQnzM0IZR60

Question And Answer	Gary Burton, Chick Corea, Roy Haynes, Dave Holland, Pat Metheny	Like Minds	spotify:track:694Jod3Fx5RLO7s9lSm2ef

Ruby, My Dear	Thelonious Monk, John Coltrane	Thelonious Monk with John Coltrane (OJC Remaster)	spotify:track:4WQfAA41hvXY1S9sk0LpGE

Will You Still Be Mine	Cal Tjader	Latin Kick	spotify:track:1r4UfeMxi89peBeWmAZoxk

So Nice	Walter Wanderley	Collection	spotify:track:5VGQAt9kld7UfJ99diFFu4

Four On Six	Wes Montgomery	Incredible Jazz Guitar	spotify:track:2Mq2Fzc9HBgvsijVFdSXUl

O samba e o tango (Chegou a hora)	Angela Maria, Waldir Calmon e Seu Conjunto	Babalu	spotify:track:3Z0Kiz1yOqC3AsTe71dEoi

Song Of The Jet	Walter Wanderley	Rain Forest (Reissue)	spotify:track:1uBsrJvVbNds5gxwXRhT2V

Vivre Pour Vivre	Francis Lai	Le Cin√©ma De Francis Lai	spotify:track:2jA7IONZUcWrYxEMnwAPDZ

Moonlight in Vermont 2	Cal Tjader	Latin Kick	spotify:track:3MDbuibECatB5nGbFfEOBs

Cried, Cried	Walter Wanderley	Rain Forest (Reissue)	spotify:track:7hV9O8Na5lwSs6svxq2vF0

Tsarka	Rabih Abou-Khalil	Blue Camel	spotify:track:50tMZeJfcxKnwd2bS7fqDu

Take Five	The Dave Brubeck Quartet	Time Out	spotify:track:1YQWosTIljIvxAgHWTp7KP

Crickets Sing For Ana Maria	Walter Wanderley	Instrumental Bossa Nova	spotify:track:7gawhMMqrEEmAx4QMirFuF

Bye Bye Blues	Cal Tjader	Latin Kick	spotify:track:3hnWUPpS5358FlR0HvxL1L

Far More Blue	The Dave Brubeck Quartet	Time Further Out	spotify:track:2djpFaL4yqTH3fvDKijsMv

Black Orchid	Cal Tjader, Eddie Palmieri	Breeze From The East	spotify:track:7rRICCykmyR8GivHqWM9RK

It's Easy To Say Goodbye	Walter Wanderley	Rain Forest (Reissue)	spotify:track:7khNSeW48DBZuHhKoK7PfX

Morning	Cal Tjader	Agua Dulce	spotify:track:13dpWWcBZMm5HdtHzQWbD9

Taste Of Sadness	Walter Wanderley	Rain Forest (Reissue)	spotify:track:6jnsNUKuvVmkDndeoo1qEx

Real Hot	Lennie Hibbert	Soul Jazz Records Presents 100% Dynamite! Ska, Soul, Rocksteady and Funk in Jamaica	spotify:track:2QY29NFXcDXxHTRSVAp3fv

O Ipod da Mina	Antonio Pinto	City of Men (The Soundtrack)	spotify:track:52rxMUReB926hiQtUK8lhW

Groovin' High	Dizzy Gillespie	Groovin' High	spotify:track:7dzNuRBCw16p1lHKF0vYpx

Viva Tirado	El Chicano	Lifestyle2 - Latin Jazz Vol 2 (International Version)	spotify:track:6jOC9iaTzTc8GlD4S0bEgQ



turnt

Intro	Kanye West	The College Dropout	spotify:track:3a1FXBrLTZWoE9TV7G3nEs

Young Master	Higher Brothers	Black Cab	spotify:track:52Np98dsECVJpOkQ3GHluU

untitled 07 levitate	Kendrick Lamar	untitled 07 levitate	spotify:track:4A5JwTktOqMtayAVVmrDzE

Wyclef Jean	Young Thug	JEFFERY	spotify:track:55OdqrG8WLmsYyY1jijD9b

T-Shirt	Migos	Culture	spotify:track:7KOlJ92bu51cltsD9KU5I7

IT G MA REMIX (feat. A$AP Ferg, Father, Dumbfoundead, Waka Flocka Flame)	Keith Ape, A$AP Ferg, Father, Dumbfoundead, Waka Flocka Flame	IT G MA REMIX (feat. A$AP Ferg, Father, Dumbfoundead, Waka Flocka Flame)	spotify:track:0gpFiquPvir7e3RrM4kii9

HUMBLE.	Kendrick Lamar	DAMN.	spotify:track:7ujx3NYtwO2LkmKGz59mXp

pick up the phone	Young Thug, Travis Scott	Birds In The Trap Sing McKnight	spotify:track:20dP2DaMHIAmwWAbp7peSr

Collard Greens	ScHoolboy Q, Kendrick Lamar	Oxymoron (Deluxe)	spotify:track:311fWdp7RrvN4Fuz7sv6Ea

Minnesota	Lil Yachty, Quavo, Skippa Da Flippa, Young Thug	Lil Boat	spotify:track:2BuiPl9kQIqW4Uuce65MZq

Pt. 2	Kanye West	The Life Of Pablo	spotify:track:0LICWCq1eL0Ja77QgOn5M3

Blue Suede	Vince Staples	Hell Can Wait	spotify:track:2e7FfubAC1P5SbVTIfj0ih

Isabellae	Higher Brothers	Black Cab	spotify:track:2QSOWm1cCNHarRUZMVeb3P

No More Parties In LA	Kanye West	The Life Of Pablo	spotify:track:4DID8YTzKYIWW3TL6kRVUe

Bad and Boujee (feat. Lil Uzi Vert)	Migos, Lil Uzi Vert	Culture	spotify:track:4Km5HrUvYTaSUfiSGPJeQR

Mask Off - Remix	Future, Kendrick Lamar	Mask Off (Remix)	spotify:track:6DB2KOEwHnjkgEnBt5SdeJ

65 Hunnid	Vince Staples	Hell Can Wait	spotify:track:4CDVtGS21q2sHRwkYqGGiH

Old English	Young Thug, A$AP Ferg, Freddie Gibbs	Old English	spotify:track:2MO3mSPBH8U9qalH72vqZ1

DipSet	Lil Yachty, Offset	Summer Songs 2	spotify:track:7q1ttR1RTK3hHjU2SCE52E

QUEER	BROCKHAMPTON	SATURATION II	spotify:track:4sEnZad9gvLSLkyt8DW11O

Made In China	Higher Brothers, Famous Dex	Black Cab	spotify:track:484SLUDMf2BmrUwtQWkvUa

Alright	Kendrick Lamar	Alright	spotify:track:0MOaqn7aBYwXOnQ08GEpDA

Shabba (feat. A$AP Rocky)	A$AP Ferg, A$AP Rocky	Trap Lord	spotify:track:7eaKWfov7b2Qa2n6HTesL3

STAR	BROCKHAMPTON	SATURATION	spotify:track:1xfFPJdRjgDAaMcDgbXwyh

Call Ticketron	Run The Jewels	Run the Jewels 3	spotify:track:6M3RWxZ2aRapomSbsy5Zvl

Peek A Boo	Lil Yachty, Migos	Teenage Emotions	spotify:track:01VvADRZqvXrHfwAKUOS8v

Yeah Right	Vince Staples	Big Fish Theory	spotify:track:5ZrDbBB4UhYMsPA3xRKOzV

Flood Watch	Juicy J, Offset	Flood Watch	spotify:track:1oJy4Imge6M4SoJlHwMWP7

i	Kendrick Lamar	i	spotify:track:69x16JmnJxuLVP9ELBoY03

WeChat	Higher Brothers, Keith Ape	Black Cab	spotify:track:49iftzwMkjN6d8YI7fsB7t

THat Part	ScHoolboy Q, Kanye West	Blank Face LP	spotify:track:78zC6abUHZ9ntpqLXMqrmo

U.O.E.N.O. (feat. Kendrick Lamar, Ab-Soul & Jay Rock)	ScHoolboy Q, Kendrick Lamar, Ab-Soul	Schoolboy Q	spotify:track:2TOYImwnVkeQcx1mMuSEF2

Banana Clipper	Run The Jewels, Big Boi	Run The Jewels (Deluxe European Edition)	spotify:track:7u9szLn7CWcWtiYcRLy0Ab

Gospel	Rich Brian, Keith Ape, XXXTENTACION	Gospel	spotify:track:7uuBfgY1vBCalrQRyyQhqs

XO TOUR Llif3	Lil Uzi Vert	XO TOUR Llif3	spotify:track:2eMwDehkIC1j68U6FA3Eiq

Swang	Rae Sremmurd	SremmLife 2 (Deluxe)	spotify:track:4VSVT9njJD3BsXIdCNHOVQ

Congratulations	Post Malone, Quavo	Stoney	spotify:track:6syOdAs4IK8kPWR7gDyjRw

Bodak Yellow	Cardi B	Bodak Yellow	spotify:track:2771LMNxwf62FTAdpJMQfM

BabyWipe	Ski Mask The Slump God	You Will Regret	spotify:track:6AraU35pOYcVABLdTZ1GKT

Achoo	Ski Mask The Slump God, Keith Ape	Achoo	spotify:track:7sYyFKYrEjB34gOkggk0vh

All Day	Kanye West, Theophilus London, Allan Kingdom, Paul McCartney	All Day	spotify:track:1YD3Dg7Olipi5FGVDLHWAu

Lemon	N.E.R.D, Rihanna	Lemon	spotify:track:6tUgfsOa8PLkoede5nOR7D

Tomboy	Princess Nokia	1992 Deluxe	spotify:track:6M1sRwraMMNUVCLUvo4e1B

Kitana	Princess Nokia	1992 Deluxe	spotify:track:0BgOvu0E3ZgzVjZTtOmC1s



when u drown ur girl

Next of Kin	Alvvays	Alvvays	spotify:track:4vblt7CJo0ffAF5kB43CMb

Blue Train Lines	Mount Kimbie, King Krule	Blue Train Lines	spotify:track:2OXPXutnpm5WnBH6xAWyFM

Let Her Go	Mac DeMarco	Salad Days	spotify:track:7KmawNv6JUgZ54gSyVF6VQ

Swim Good	Frank Ocean	Swim Good	spotify:track:0ytw2owVvegkIS87txqV1O

Only God Knows	Young Fathers, Leith Congregational Choir	Only God Knows	spotify:track:7vmLW0qZn0vBgH6WN7ZAnC

Love Interruption	Jack White	Blunderbuss	spotify:track:3s3ciLHOXE1xVqGkdxwHPs



trip

Uncharted Worlds	Sam Hulick, EA Games Soundtrack	Mass Effect (EA Games Soundtrack)	spotify:track:4Oti7gFJj6BqyRlzujmXBw

Dust	M|O|O|N	Particles	spotify:track:5UFXAE1QXIGnmALcrQ4DgZ

The Illusive Man	Jack Wall	Mass Effect 2 (Original Soundtrack)	spotify:track:1DvON6HkWKnZQCldczFqSA

Paris	M|O|O|N	Moon - EP	spotify:track:4PbZ1dClx4HnT67mPcbyXz

I Am Alive and I Am Not Alone	Sam Hulick	Mass Effect 3: Extended Cut	spotify:track:4vsidZNJ3OBPcx8swHDVq4

New Worlds	Jack Wall	Mass Effect 2 (Original Soundtrack)	spotify:track:3slNxgbmELvcfxahtfpXE0

Release	M|O|O|N	Moon - EP	spotify:track:2vRSzbCIMogeAoCmleuCIy



i study politics

FDT	YG, Nipsey Hussle	Still Brazy (Deluxe)	spotify:track:3Oi6fxQeiM4NvarxLjkui6

War Is Coming (If You Want It)	Car Seat Headrest	War Is Coming (If You Want It)	spotify:track:76r8BBGixz8suvdjcxMze3

The Blacker The Berry	Kendrick Lamar	To Pimp A Butterfly	spotify:track:0mRxPVluGvxD6TitLPcbYt

Bored in the USA	Father John Misty	I Love You, Honeybear	spotify:track:0kT6Irmpxfwnn9vCQBTJ79

Institutionalized	Kendrick Lamar, Bilal, Anna Wise, Snoop Dogg	To Pimp A Butterfly	spotify:track:5kqQoLsjAHHxXmVe4oBT83

Holy Shit	Father John Misty	I Love You, Honeybear	spotify:track:2RDwuf0171bBWVYNXHseVR

untitled 03 05.28.2013.	Kendrick Lamar	untitled unmastered.	spotify:track:5RGmEJmkPghFXU8ZD1ZB7L

Ballad of the Dying Man	Father John Misty	Pure Comedy	spotify:track:3twj6MfdyZ7Ii8oNAH1g3z

Sleep Now In the Fire	Rage Against The Machine	The Battle Of Los Angeles	spotify:track:1MQTmpYOZ6fcMQc56Hdo7T

America	Foxygen	America	spotify:track:3m4O9nrBV434mYNN3YyuJo



