track_name	artist_name	album_name	track_uri
December 13, 2017: Geminid Meteor Shower	Sleeping At Last	December 13, 2017: Geminid Meteor Shower	spotify:track:4FbL7Xwyzb6Mgfyb58pwKi

Melatonin (Unplugged)	Phoria	Melatonin (Unplugged)	spotify:track:1IkjoLXB9LEf3w32Wk07X3

Discovery	AK	Discovery	spotify:track:5bO33fxvcGqZp7Pw3zIQsj

Reverie	Michael St Laurent	Reverie	spotify:track:5YO507pZDJVbPdTcGk4p8F

Eternal	Beauvois	Eternal	spotify:track:6Qf28icniecICVBLw2rMgu

Reminiscence	Johannes Bornlöf	As The Years Go By	spotify:track:1FwYuCPPEepHIWydsi37gI

Flying	AK	Flying	spotify:track:5zg8reGM7xzollYjW37Vnx

Quiet Eyes	Axel Flóvent	Quiet Eyes	spotify:track:2sSggPL7L5gfYU6oar80U9

Silent Letters	Hushed	A Faint Glow	spotify:track:40ZGccjoBDUGXl4SgpOg26

Far Away	Elena Fallwell	Far Away	spotify:track:1mqK2PZBW1KAjERJkoIRKe

20:17	Ólafur Arnalds, Nils Frahm	Trance Frendz	spotify:track:2V539MV3mX2iNjpaalJeqH

Craving	ford., Sarah Kinsley	(The) Evening	spotify:track:3aIUH5on4PzWxTsAf8AcU7

Breathing	Kazukii, Among the Others, Matt Van	Breathing	spotify:track:3l0t5qfiANxTDG6N4Abjo3

The Black and White	The Band CAMINO	My Thoughts on You	spotify:track:6KtCRh78Hl0bgWvkruPNcs

31 / 10	RKCB, Dave Gibson	RKCB-Sides	spotify:track:4TwbiHzsLKYydj4CxrufQB

Cool Again	Shoffy	Lenses	spotify:track:0xM6mdl0XX2qOqUZmVUp97

Better Than Today	Rhys Lewis	Better Than Today	spotify:track:6MLHg35rlksBc5OBcdZvJi

Sleepless Nights	ayokay, Nightly	In the Shape of a Dream	spotify:track:4PUWpNtDejQwwa80LjvxXl

All I Got	Said the Sky, Kwesi	Wide-Eyed	spotify:track:1iaTDu4PCIWQQOwwwqq5qW

All Your Days	Shallou, Emmit Fenn	All Your Days	spotify:track:2QEBXYzURjg7nY8FjbBcUt

Love Alone	Mokita	Love Alone	spotify:track:6KUsVERTI2fY3Swi5mo27R

Come Alive	WYNNE	Come Alive	spotify:track:6SUr1F8tdHWV0T2BCX9Sri



Lulaby — Baby Sleep Music 2017

If I Stay	Emanuele Moratori	Baby Sleep Music 2017	spotify:track:2LoXMx35elD3CwcxDK94T9

Una Mattina	Marco Russalo	Baby Sleep Music 2017	spotify:track:5zScdSE7f4FCLIl89mj3l5

The Green Miles	Agapov Serené	Baby Sleep Music 2017	spotify:track:3b8xTb0hcEo5piyQR3oGKn

Consoslation No. 3	Emanuele Moratori	Baby Sleep Music 2017	spotify:track:5WVhv0EcDXpWchbn7HH5Gn

Nuvole Bianche	Emanuele Moratori	Baby Sleep Music 2017	spotify:track:3Nf6kBiJ5skquIihUwq5SF

Cavatina	Giulia Rossa	Baby Sleep Music 2017	spotify:track:5SoQzfRcX66AD7D1aNgsa7

Primavera	Agapov Serené	Baby Sleep Music 2017	spotify:track:3rJ4xNddsFwIU6SmY6DVSl

Moonlight Sonata	Tyko Vasiliev	Baby Sleep Music 2017	spotify:track:4LEt8oe0vqxxEElzfXelCm

Nocturne No. 1	Tyko Vasiliev	Baby Sleep Music 2017	spotify:track:33jeZ1mXAQBGV2MswQYvFs

Bu Ert Joroin	Frida Bark	Baby Sleep Music 2017	spotify:track:3JkkFXwOGLBWx6m6lVMczh

Theme from the Notebook	Ilya Petrovare	Baby Sleep Music 2017	spotify:track:3kgeYDc0rakJ9j0cIMDXzH

I Giorni	Agapov Serené	Baby Sleep Music 2017	spotify:track:3esu8e7yivEOgE5FimbWyG

Film Credits	Frida Bark	Baby Sleep Music 2017	spotify:track:3NPFyLx8CKhdC2nmzN1neA

Fyrsta	Frida Bark	Baby Sleep Music 2017	spotify:track:6U2SHHdSkjAhBHlyuYEA6H

Ljosio	Frida Bark	Baby Sleep Music 2017	spotify:track:1IrxLQxyewrevbAASk91O2

Suite no 1 for Cello	Giulia Rossa	Baby Sleep Music 2017	spotify:track:0wkHDLOT3du5hMOvEIq8Fk

Greensleaves	Rob Giordani	Baby Sleep Music 2017	spotify:track:7BtxWoGytVsHevJHEDPqqh

Near Light	Frida Bark	Baby Sleep Music 2017	spotify:track:0C0CKFbOC9brhJLydfex0k

Traumeräi	Agapov Serené	Baby Sleep Music 2017	spotify:track:6y6j409cRHDO1NgBMtGwNL

Color Purple	Marco Russalo	Baby Sleep Music 2017	spotify:track:63JU1iwXGOR3O4S64Ofko4

Tomorrows song	Frida Bark	Baby Sleep Music 2017	spotify:track:6hdUYokLfQfNmXa7aDpyhO

Canon in D	Tyko Vasiliev	Baby Sleep Music 2017	spotify:track:2OpcIJAmfAXPPDC9HklH03

English Suite No. 2	Giulia Rossa	Baby Sleep Music 2017	spotify:track:6rPI4PvFUjRrqVdVdkqe0y

Summerland	Ilya Petrovare	Baby Sleep Music 2017	spotify:track:72ArsWh0n0XeQ9ME3Ugvuj

Les Adieux	Emanuele Moratori	Baby Sleep Music 2017	spotify:track:5Pri5FFJ3k6cC4Eq21EZGH

Schindlers List	Tyko Vasiliev	Baby Sleep Music 2017	spotify:track:4a3opRbcgwWSxKQc7mfJgn

Soledad	Ilya Petrovare	Baby Sleep Music 2017	spotify:track:4RgVXR4erDKT9vMhFjxvo8

Sweet Mystery	Ilya Petrovare	Baby Sleep Music 2017	spotify:track:2OX2D21Y5L2pluWeNJIGWy

Air	Giulia Rossa	Baby Sleep Music 2017	spotify:track:1acHosWCea1N5F1HLC3wmT

Tangerine	Ilya Petrovare	Baby Sleep Music 2017	spotify:track:7DjpO1BgJYOEDSfLdzO4Bx

Fly	Rob Giordani	Baby Sleep Music 2017	spotify:track:7MzH67LiugVnIB97TvWnwL

Claire De Lune	Marco Russalo	Baby Sleep Music 2017	spotify:track:5Bg7044xP5VApc9itwBOHp

Gnossiennes	Rob Giordani	Baby Sleep Music 2017	spotify:track:68ocDm6fCTa7C3W9GNgKhd

Heaven Knows	Rob Giordani	Baby Sleep Music 2017	spotify:track:1dFNniUMv0V5QK20uaw0bZ

Songs Without Words	Marco Russalo	Baby Sleep Music 2017	spotify:track:3Rl54Sg4CPSHluL1TxC6am

Comptine d'un autre été	Agapov Serené	Baby Sleep Music 2017	spotify:track:6Ngy9izaEofIf5KpVJtyLr

Nocturnes Op.55	Marco Russalo	Baby Sleep Music 2017	spotify:track:3yutVJ2C8aDyi98fEw6UlM

Gymnopedie	Rob Giordani	Baby Sleep Music 2017	spotify:track:7egOE2kKHALRjrPLAnsLvE

The Goldberg Variations	Giulia Rossa	Baby Sleep Music 2017	spotify:track:07u41UESyfq4rKa2ik0k7f

River Flows In You	Tyko Vasiliev	Baby Sleep Music 2017	spotify:track:6UucRqgQ3olcCxrz9CMTvo

Kiss The Rain	Emanuele Moratori	Baby Sleep Music 2017	spotify:track:5WuRudvRjjXzU2ZxHxb31o

Baby Lullaby Music	Einstein Baby Lullaby Academy	Baby Lullaby: Relaxing Piano Lullabies and Natural Sleep Aid for Baby Sleep Music	spotify:track:1YiknHCa9pXZVKWUYeNgbx

Rock a Bye Baby	Einstein Baby Lullaby Academy	Baby Lullaby: Relaxing Piano Lullabies and Natural Sleep Aid for Baby Sleep Music	spotify:track:586k3MTMSuIDdPMMKuGIq3

Piano Baby Lullabies for Baby Sleep	Einstein Baby Lullaby Academy	Baby Lullaby: Relaxing Piano Lullabies and Natural Sleep Aid for Baby Sleep Music	spotify:track:3SPCtqHndiHRNZEXAVFNLk

Twinkle Twinkle Little Star	Einstein Baby Lullaby Academy	Baby Lullaby: Relaxing Piano Lullabies and Natural Sleep Aid for Baby Sleep Music	spotify:track:4Vk87DhbvFoRjwO1C1vOuH

Classical Piano Music for Baby Sleep	Einstein Baby Lullaby Academy	Baby Lullaby: Relaxing Piano Lullabies and Natural Sleep Aid for Baby Sleep Music	spotify:track:2JxS3A9SqhMz1N48u08mEu

It's a Small World	Einstein Baby Lullaby Academy	Baby Lullaby: Relaxing Piano Lullabies and Natural Sleep Aid for Baby Sleep Music	spotify:track:5LYfQZYMd68djkPOzfQxRM

Calm Piano Music for Sleeping Baby	Einstein Baby Lullaby Academy	Baby Lullaby: Relaxing Piano Lullabies and Natural Sleep Aid for Baby Sleep Music	spotify:track:00VTfUwDgbzKDirC6PZwZX

Brahm's Lullaby	Einstein Baby Lullaby Academy	Baby Lullaby: Relaxing Piano Lullabies and Natural Sleep Aid for Baby Sleep Music	spotify:track:7J8drFuULgXhcZm9Lr6b0H

Bedtime Music for Baby Sleep	Einstein Baby Lullaby Academy	Baby Lullaby: Relaxing Piano Lullabies and Natural Sleep Aid for Baby Sleep Music	spotify:track:3wPCo8Y88QMizxUgMwSsHr

Baby Songs Sleep	Einstein Baby Lullaby Academy	Baby Lullaby: Relaxing Piano Lullabies and Natural Sleep Aid for Baby Sleep Music	spotify:track:282ynRorYNlfgEGRL8WYWd

Hush Little Baby	Einstein Baby Lullaby Academy	Baby Lullaby: Relaxing Piano Lullabies and Natural Sleep Aid for Baby Sleep Music	spotify:track:1pNQKV0LjUwxpLC1uPxUSt

Soft Piano for Baby Sleep	Einstein Baby Lullaby Academy	Baby Lullaby: Relaxing Piano Lullabies and Natural Sleep Aid for Baby Sleep Music	spotify:track:5CYqC6c98UYooyrvu3hrKm

Sleeping Music and Sleep Music	Einstein Baby Lullaby Academy	Baby Lullaby: Relaxing Piano Lullabies and Natural Sleep Aid for Baby Sleep Music	spotify:track:4m2dPyd2y0CHRDy6a7K42d

Baby Lullaby Sleep	Einstein Baby Lullaby Academy	Baby Lullaby: Relaxing Piano Lullabies and Natural Sleep Aid for Baby Sleep Music	spotify:track:1Mzjfbcp3iZ6AZA8WMeu6f

Canon in D	Einstein Baby Lullaby Academy	Baby Lullaby: Relaxing Piano Lullabies and Natural Sleep Aid for Baby Sleep Music	spotify:track:7eP2WuhwRgLFDCmOGdrgHc

Sleeping Baby	Einstein Baby Lullaby Academy	Baby Lullaby: Relaxing Piano Lullabies and Natural Sleep Aid for Baby Sleep Music	spotify:track:38p90tiP5Dm9CREuWXqssg

Baby Einstein Music Piano	Einstein Baby Lullaby Academy	Baby Lullaby: Relaxing Piano Lullabies and Natural Sleep Aid for Baby Sleep Music	spotify:track:702kdGn6Kt8UTHsvrnIpO6

Frere Jacques	Einstein Baby Lullaby Academy	Baby Lullaby: Relaxing Piano Lullabies and Natural Sleep Aid for Baby Sleep Music	spotify:track:0VLCvHYSiOOtn7g5P2PuMU

Classical Piano for Sleeping Music	Einstein Baby Lullaby Academy	Baby Lullaby: Relaxing Piano Lullabies and Natural Sleep Aid for Baby Sleep Music	spotify:track:0G7sG61Xp7vTTQHr7sBqOj

Background Baby Music	Einstein Baby Lullaby Academy	Baby Lullaby: Relaxing Piano Lullabies and Natural Sleep Aid for Baby Sleep Music	spotify:track:1P4dzdf9DznSbBRzUmWQfX

The Itsy Bitsy Spider	Einstein Baby Lullaby Academy	Baby Lullaby: Relaxing Piano Lullabies and Natural Sleep Aid for Baby Sleep Music	spotify:track:4NqQyVtD910QDY5ZWmS7Pk

Piano Songs for Baby Sleep	Einstein Baby Lullaby Academy	Baby Lullaby: Relaxing Piano Lullabies and Natural Sleep Aid for Baby Sleep Music	spotify:track:2dmpKivhz8nbQUVG4ArywT

Baby Lullaby and Children's Music	Einstein Baby Lullaby Academy	Baby Lullaby: Relaxing Piano Lullabies and Natural Sleep Aid for Baby Sleep Music	spotify:track:5bomw4Am9pmEoYZC8yfolp

Mary Had a Little Lamb	Einstein Baby Lullaby Academy	Baby Lullaby: Relaxing Piano Lullabies and Natural Sleep Aid for Baby Sleep Music	spotify:track:25JvyVqmjYf51fmFz8713K

Lullabies for Babies	Einstein Baby Lullaby Academy	Baby Lullaby: Relaxing Piano Lullabies and Natural Sleep Aid for Baby Sleep Music	spotify:track:1X1RoElgyn1oal9WJg4tvv

Naptime Baby Music and Lullabies for Sleep	Einstein Baby Lullaby Academy	Baby Lullaby: Relaxing Piano Lullabies and Natural Sleep Aid for Baby Sleep Music	spotify:track:44mhq1cbr4jJBS6NWrp48v

Nursery Rhymes for Babies	Einstein Baby Lullaby Academy	Baby Lullaby: Relaxing Piano Lullabies and Natural Sleep Aid for Baby Sleep Music	spotify:track:4yTUPXwnuekYsdbol53mjn

Music for Breastfeeding and Breastfeeding Music	Einstein Baby Lullaby Academy	Baby Lullaby: Relaxing Piano Lullabies and Natural Sleep Aid for Baby Sleep Music	spotify:track:5nyD84fPzisNpjwcmYk9SZ

Piano Music for Babies	Einstein Baby Lullaby Academy	Baby Lullaby: Relaxing Piano Lullabies and Natural Sleep Aid for Baby Sleep Music	spotify:track:49HNeV22KMqouLlLp5obY3

Row Row Row Your Boat	Einstein Baby Lullaby Academy	Baby Lullaby: Relaxing Piano Lullabies and Natural Sleep Aid for Baby Sleep Music	spotify:track:3hjUeVbxkloUUMfBDCYDpc

Bedtime Baby and Sleeping Music	Einstein Baby Lullaby Academy	Baby Lullaby: Relaxing Piano Lullabies and Natural Sleep Aid for Baby Sleep Music	spotify:track:5pt4ph16WkQngGqUIMUGFF

Relaxing Piano Music Sleep Aid	Einstein Baby Lullaby Academy	Baby Lullaby: Relaxing Piano Lullabies and Natural Sleep Aid for Baby Sleep Music	spotify:track:2mRj3lfrVkYgZqRc3OD2KU

Music for Crying Baby	Einstein Baby Lullaby Academy	Baby Lullaby: Relaxing Piano Lullabies and Natural Sleep Aid for Baby Sleep Music	spotify:track:4jn8tyUfu7YadZfC2QrAHI

Relaxing Sleep Music for Babies	Einstein Baby Lullaby Academy	Baby Lullaby: Relaxing Piano Lullabies and Natural Sleep Aid for Baby Sleep Music	spotify:track:6C8rUAPzpD0zvg7czNoEF2

Children's Songs and Baby Lullabies	Einstein Baby Lullaby Academy	Baby Lullaby: Relaxing Piano Lullabies and Natural Sleep Aid for Baby Sleep Music	spotify:track:2F8wyxq3QNooRmskA9e7nl

Smart Baby Piano Music	Einstein Baby Lullaby Academy	Baby Lullaby: Relaxing Piano Lullabies and Natural Sleep Aid for Baby Sleep Music	spotify:track:2TbWIYVl5o7GGUaYzCgf0t

Cure Insomnia Sleeping Music	Einstein Baby Lullaby Academy	Baby Lullaby: Relaxing Piano Lullabies and Natural Sleep Aid for Baby Sleep Music	spotify:track:4d9zJqPsgyGxHQb2vcybz1

Soothing Piano for Baby Sleep	Einstein Baby Lullaby Academy	Baby Lullaby: Relaxing Piano Lullabies and Natural Sleep Aid for Baby Sleep Music	spotify:track:60dUN0TdqxladF6YAWmCT0

Newborn Natural Sleep Aid for Baby Sleep	Einstein Baby Lullaby Academy	Baby Lullaby: Relaxing Piano Lullabies and Natural Sleep Aid for Baby Sleep Music	spotify:track:4nHjKbijTrJkO8nfsbbgDP

Baby Lullaby Piano	Einstein Baby Lullaby Academy	Baby Lullaby: Relaxing Piano Lullabies and Natural Sleep Aid for Baby Sleep Music	spotify:track:0QGS9Nyd0aG5Sf0luWxHBd